rank_name	truth_sample	model	snv	level_4	bin	min_score	max_score	n_alleles	tp	fp	fn	cum_alleles	cum_tp	cum_fp	cum_fn	cum_tn	precision	recall	data_type
global_rank	NA12878	RF	False	0	0.0	0.9097005078617172	0.9173004202466639	18	16	0	2	18	16	0	2418	415	1.0	0.00657354149548069	exomes
global_rank	NA12878	RF	False	4	1.0	0.9034395286887051	0.9034395286887051	1	1	0	0	19	17	0	2417	415	1.0	0.006984387838948234	exomes
global_rank	NA12878	RF	False	7	2.0	0.8993070225680602	0.9019848646636509	18	17	1	0	37	34	1	2400	414	0.9714285714285714	0.013968775677896467	exomes
global_rank	NA12878	RF	False	11	3.0	0.8961073220159511	0.8992523567789769	16	14	0	2	53	48	1	2386	414	0.9795918367346939	0.01972062448644207	exomes
global_rank	NA12878	RF	False	15	4.0	0.8928762187590935	0.8956749963423354	25	22	0	3	78	70	1	2364	414	0.9859154929577465	0.02875924404272802	exomes
global_rank	NA12878	RF	False	19	5.0	0.8882560774519489	0.89279992156938	20	15	0	5	98	85	1	2349	414	0.9883720930232558	0.03492193919474117	exomes
global_rank	NA12878	RF	False	23	6.0	0.8806641782978093	0.8871343302736288	49	41	2	6	147	126	3	2308	412	0.9767441860465116	0.051766639276910435	exomes
global_rank	NA12878	RF	False	27	7.0	0.8714737110930202	0.8805940671833279	56	42	0	14	203	168	3	2266	412	0.9824561403508771	0.06902218570254724	exomes
global_rank	NA12878	RF	False	31	8.0	0.8621427524915519	0.8713601595759073	33	28	1	4	236	196	4	2238	411	0.98	0.08052588331963846	exomes
global_rank	NA12878	RF	False	35	9.0	0.8569342022865667	0.8609747582810883	14	9	0	5	250	205	4	2229	411	0.9808612440191388	0.08422350041084635	exomes
global_rank	NA12878	RF	False	39	10.0	0.8548972915771212	0.8565693820209032	25	25	0	0	275	230	4	2204	411	0.9829059829059829	0.09449465899753492	exomes
global_rank	NA12878	RF	False	43	11.0	0.8513364129733192	0.8543014337203688	145	145	0	0	420	375	4	2059	411	0.9894459102902374	0.15406737880032867	exomes
global_rank	NA12878	RF	False	47	12.0	0.8497038137448159	0.8513364129733192	40	38	0	2	460	413	4	2021	411	0.9904076738609112	0.16967953985209533	exomes
global_rank	NA12878	RF	False	51	13.0	0.8468348153688882	0.8493360364741178	22	21	0	1	482	434	4	2000	411	0.9908675799086758	0.17830731306491374	exomes
global_rank	NA12878	RF	False	55	14.0	0.8435338996830251	0.8463682824109631	32	31	0	1	514	465	4	1969	411	0.9914712153518124	0.19104354971240756	exomes
global_rank	NA12878	RF	False	59	15.0	0.840303728911156	0.8434502422856223	220	212	2	6	734	677	6	1757	409	0.9912152269399708	0.27814297452752673	exomes
global_rank	NA12878	RF	False	63	16.0	0.8371417369750361	0.840303728911156	29	29	0	0	763	706	6	1728	409	0.9915730337078652	0.2900575184880855	exomes
global_rank	NA12878	RF	False	67	17.0	0.8346981449708728	0.8370574648708399	29	26	1	2	792	732	7	1702	408	0.9905277401894452	0.30073952341824156	exomes
global_rank	NA12878	RF	False	71	18.0	0.8322025731503658	0.8344413119624421	67	65	1	1	859	797	8	1637	407	0.9900621118012423	0.32744453574363186	exomes
global_rank	NA12878	RF	False	75	19.0	0.8300997090145237	0.832048148481885	216	215	1	0	1075	1012	9	1422	406	0.9911851126346719	0.41577649958915364	exomes
global_rank	NA12878	RF	False	79	20.0	0.826429306944108	0.8299145833507162	40	39	0	1	1115	1051	9	1383	406	0.9915094339622641	0.43179950698438785	exomes
global_rank	NA12878	RF	False	83	21.0	0.8236519263498336	0.8263056088994613	26	26	0	0	1141	1077	9	1357	406	0.9917127071823204	0.44248151191454393	exomes
global_rank	NA12878	RF	False	87	22.0	0.8205055292584809	0.8234765829591467	124	122	0	2	1265	1199	9	1235	406	0.9925496688741722	0.4926047658175842	exomes
global_rank	NA12878	RF	False	91	23.0	0.8171058021516165	0.8202367162008958	49	43	1	5	1314	1242	10	1192	405	0.9920127795527156	0.5102711585866886	exomes
global_rank	NA12878	RF	False	95	24.0	0.8138199067623153	0.8167616605996144	35	32	2	1	1349	1274	12	1160	403	0.9906687402799378	0.5234182415776499	exomes
global_rank	NA12878	RF	False	99	25.0	0.8115281902871019	0.8136352947894289	32	31	0	1	1381	1305	12	1129	403	0.9908883826879271	0.5361544782251438	exomes
global_rank	NA12878	RF	False	103	26.0	0.8085957560171243	0.8110180870102199	31	28	0	3	1412	1333	12	1101	403	0.9910780669144982	0.547658175842235	exomes
global_rank	NA12878	RF	False	107	27.0	0.8060627543991067	0.8085437023465745	17	15	0	2	1429	1348	12	1086	403	0.9911764705882353	0.5538208709942481	exomes
global_rank	NA12878	RF	False	111	28.0	0.8026693909976778	0.8059310761659286	44	43	0	1	1473	1391	12	1043	403	0.9914468995010691	0.5714872637633525	exomes
global_rank	NA12878	RF	False	115	29.0	0.799105765591246	0.8025903551001334	115	111	1	3	1588	1502	13	932	402	0.9914191419141914	0.6170912078882498	exomes
global_rank	NA12878	RF	False	119	30.0	0.7951733158690898	0.7990669803951226	51	48	1	2	1639	1550	14	884	401	0.9910485933503836	0.6368118323746919	exomes
global_rank	NA12878	RF	False	123	31.0	0.7908063571016517	0.7951526051974724	63	63	0	0	1702	1613	14	821	401	0.9913952059004303	0.6626951520131471	exomes
global_rank	NA12878	RF	False	127	32.0	0.7876694649374741	0.7907763837544562	52	47	2	3	1754	1660	16	774	399	0.9904534606205251	0.6820049301561216	exomes
global_rank	NA12878	RF	False	131	33.0	0.7842563707104856	0.787361628287946	53	49	1	3	1807	1709	17	725	398	0.9901506373117034	0.7021364009860313	exomes
global_rank	NA12878	RF	False	135	34.0	0.7812275838230354	0.7841638089101227	33	25	0	8	1840	1734	17	700	398	0.9902912621359223	0.7124075595727198	exomes
global_rank	NA12878	RF	False	139	35.0	0.7774910595137313	0.7810272555311616	15	9	1	5	1855	1743	18	691	397	0.989778534923339	0.7161051766639277	exomes
global_rank	NA12878	RF	False	143	36.0	0.773843404083442	0.7773490703076131	13	7	0	6	1868	1750	18	684	397	0.9898190045248869	0.7189811010682005	exomes
global_rank	NA12878	RF	False	147	37.0	0.7696789830081476	0.7734050149407262	13	12	0	1	1881	1762	18	672	397	0.9898876404494382	0.723911257189811	exomes
global_rank	NA12878	RF	False	151	38.0	0.7665871882219034	0.7688995726461013	14	11	1	2	1895	1773	19	661	396	0.9893973214285714	0.7284305669679539	exomes
global_rank	NA12878	RF	False	155	39.0	0.7631583583197554	0.7659388247849004	18	17	0	1	1913	1790	19	644	396	0.9894969596462134	0.7354149548069022	exomes
global_rank	NA12878	RF	False	159	40.0	0.7599382110350074	0.7626530830899616	20	19	0	1	1933	1809	19	625	396	0.9896061269146609	0.7432210353327855	exomes
global_rank	NA12878	RF	False	163	41.0	0.7561694522787087	0.7596416744846618	15	14	0	1	1948	1823	19	611	396	0.989685124864278	0.7489728841413311	exomes
global_rank	NA12878	RF	False	167	42.0	0.7524058137390575	0.7556944470552275	12	12	0	0	1960	1835	19	599	396	0.9897518878101402	0.7539030402629416	exomes
global_rank	NA12878	RF	False	171	43.0	0.7484232377588739	0.7519065205067849	27	26	1	0	1987	1861	20	573	395	0.9893673577884105	0.7645850451930978	exomes
global_rank	NA12878	RF	False	175	44.0	0.7446819595505342	0.7474986111813664	14	12	1	1	2001	1873	21	561	394	0.9889123548046462	0.7695152013147083	exomes
global_rank	NA12878	RF	False	179	45.0	0.7402870447337777	0.7439541154597392	10	9	1	0	2011	1882	22	552	393	0.9884453781512605	0.7732128184059162	exomes
global_rank	NA12878	RF	False	183	46.0	0.7363648713130482	0.7399890368165308	10	8	1	1	2021	1890	23	544	392	0.9879769994772608	0.7764995891536566	exomes
global_rank	NA12878	RF	False	187	47.0	0.7311187727474081	0.734325570956229	12	10	0	2	2033	1900	23	534	392	0.9880395215808633	0.780608052588332	exomes
global_rank	NA12878	RF	False	191	48.0	0.726875163483519	0.7301340321929155	7	4	0	3	2040	1904	23	530	392	0.9880643487285937	0.7822514379622021	exomes
global_rank	NA12878	RF	False	195	49.0	0.7218487661138625	0.7259257895165049	11	9	0	2	2051	1913	23	521	392	0.9881198347107438	0.7859490550534101	exomes
global_rank	NA12878	RF	False	199	50.0	0.7158433401025012	0.7205169947558526	7	6	0	1	2058	1919	23	515	392	0.9881565396498455	0.7884141331142153	exomes
global_rank	NA12878	RF	False	203	51.0	0.7100424504044801	0.715560531388131	13	11	0	2	2071	1930	23	504	392	0.9882232462877624	0.7929334428923582	exomes
global_rank	NA12878	RF	False	207	52.0	0.7054381832514312	0.7091869421012372	7	6	0	1	2078	1936	23	498	392	0.9882593159775396	0.7953985209531635	exomes
global_rank	NA12878	RF	False	211	53.0	0.6993210638525281	0.7035459197364852	14	12	0	2	2092	1948	23	486	392	0.9883307965499746	0.8003286770747741	exomes
global_rank	NA12878	RF	False	215	54.0	0.6927369414617971	0.6974689948108852	6	6	0	0	2098	1954	23	480	392	0.9883662114314619	0.8027937551355793	exomes
global_rank	NA12878	RF	False	219	55.0	0.6857846390517282	0.6907283217191702	9	9	0	0	2107	1963	23	471	392	0.9884189325276939	0.8064913722267871	exomes
global_rank	NA12878	RF	False	223	56.0	0.6804494817430203	0.6845963643428322	16	14	0	2	2123	1977	23	457	392	0.9885	0.8122432210353328	exomes
global_rank	NA12878	RF	False	227	57.0	0.675030032226764	0.6777816257403226	5	5	0	0	2128	1982	23	452	392	0.9885286783042394	0.8142974527526705	exomes
global_rank	NA12878	RF	False	231	58.0	0.6630086432909418	0.6696742139831977	6	3	0	3	2134	1985	23	449	392	0.9885458167330677	0.8155299917830732	exomes
global_rank	NA12878	RF	False	235	59.0	0.6521270266092215	0.6609453159722256	9	8	0	1	2143	1993	23	441	392	0.9885912698412699	0.8188167625308135	exomes
global_rank	NA12878	RF	False	239	60.0	0.6417302707567947	0.6505780616013749	9	8	1	0	2152	2001	24	433	391	0.9881481481481481	0.8221035332785538	exomes
global_rank	NA12878	RF	False	243	61.0	0.6255464971206854	0.6383497570681385	6	4	0	2	2158	2005	24	429	391	0.988171513060621	0.823746918652424	exomes
global_rank	NA12878	RF	False	247	62.0	0.6043226679871769	0.6187034535320985	5	4	0	1	2163	2009	24	425	391	0.9881947860304968	0.8253903040262942	exomes
global_rank	NA12878	RF	False	251	63.0	0.5750314110140071	0.600720453883138	12	11	1	0	2175	2020	25	414	390	0.9877750611246944	0.8299096138044372	exomes
global_rank	NA12878	RF	False	255	64.0	0.5501078495186251	0.5740837249467916	9	7	1	1	2184	2027	26	407	389	0.9873356064296152	0.8327855382087099	exomes
global_rank	NA12878	RF	False	259	65.0	0.5207284812412483	0.5472684700503976	34	33	0	1	2218	2060	26	374	389	0.987535953978907	0.8463434675431388	exomes
global_rank	NA12878	RF	False	263	66.0	0.4929158217648072	0.5199685758003827	33	29	1	3	2251	2089	27	345	388	0.9872400756143668	0.8582580115036976	exomes
global_rank	NA12878	RF	False	267	67.0	0.4717480703149488	0.4911735291568212	17	15	0	2	2268	2104	27	330	388	0.987329892069451	0.8644207066557108	exomes
global_rank	NA12878	RF	False	271	68.0	0.4522019733911756	0.4686876960271681	8	8	0	0	2276	2112	27	322	388	0.9873772791023843	0.8677074774034511	exomes
global_rank	NA12878	RF	False	275	69.0	0.4319309755302595	0.4507033714177813	20	18	1	1	2296	2130	28	304	387	0.9870250231696015	0.8751027115858668	exomes
global_rank	NA12878	RF	False	279	70.0	0.4166867291576958	0.42758579226869076	9	6	2	1	2305	2136	30	298	385	0.9861495844875346	0.8775677896466721	exomes
global_rank	NA12878	RF	False	283	71.0	0.3922220428292169	0.40751478966027865	14	10	2	2	2319	2146	32	288	383	0.9853076216712581	0.8816762530813476	exomes
global_rank	NA12878	RF	False	287	72.0	0.3697120206694883	0.3850016057116962	12	9	0	3	2331	2155	32	279	383	0.9853680841335163	0.8853738701725554	exomes
global_rank	NA12878	RF	False	291	73.0	0.35451450277293484	0.3639695116506856	5	2	1	2	2336	2157	33	277	382	0.9849315068493151	0.8861955628594905	exomes
global_rank	NA12878	RF	False	295	74.0	0.3201783659428849	0.34032264301420484	12	5	5	2	2348	2162	38	272	377	0.9827272727272728	0.8882497945768283	exomes
global_rank	NA12878	RF	False	299	75.0	0.3029988891435851	0.31627969686907526	8	3	4	1	2356	2165	42	269	373	0.980969642048029	0.889482333607231	exomes
global_rank	NA12878	RF	False	303	76.0	0.27728545533570087	0.3001740488569917	14	5	5	4	2370	2170	47	264	368	0.9788001804239964	0.8915365653245686	exomes
global_rank	NA12878	RF	False	307	77.0	0.25007371777065396	0.2722605040885598	15	5	10	0	2385	2175	57	259	358	0.9744623655913979	0.8935907970419064	exomes
global_rank	NA12878	RF	False	311	78.0	0.2305371160907118	0.24849966901827963	25	6	19	0	2410	2181	76	253	339	0.9663269827204254	0.8960558751027116	exomes
global_rank	NA12878	RF	False	315	79.0	0.20657127737508146	0.22871786456506069	17	1	15	1	2427	2182	91	252	324	0.9599648042234932	0.8964667214461791	exomes
global_rank	NA12878	RF	False	319	80.0	0.183742667553594	0.20072754676709587	9	1	8	0	2436	2183	99	251	316	0.9566170026292725	0.8968775677896467	exomes
global_rank	NA12878	RF	False	323	81.0	0.16232045041768722	0.18177759008988195	29	1	28	0	2465	2184	127	250	288	0.9450454348766768	0.8972884141331142	exomes
global_rank	NA12878	RF	False	327	82.0	0.15433218816591332	0.1621355514640851	85	0	85	0	2550	2184	212	250	203	0.9115191986644408	0.8972884141331142	exomes
global_rank	NA12878	RF	False	330	83.0	0.14326166583229485	0.15427455836096832	49	4	45	0	2599	2188	257	246	158	0.8948875255623722	0.8989317995069844	exomes
global_rank	NA12878	RF	False	334	84.0	0.13048469451910485	0.14220923788878678	45	0	45	0	2644	2188	302	246	113	0.878714859437751	0.8989317995069844	exomes
global_rank	NA12878	RF	False	337	85.0	0.12165563476500779	0.12802114867158773	27	0	27	0	2671	2188	329	246	86	0.8692888359157728	0.8989317995069844	exomes
global_rank	NA12878	RF	False	341	86.0	0.11144072141014869	0.11802010890426436	15	0	15	0	2686	2188	344	246	71	0.8641390205371248	0.8989317995069844	exomes
global_rank	NA12878	RF	False	344	87.0	0.10565854248786691	0.1092933422552457	18	0	18	0	2704	2188	362	246	53	0.8580392156862745	0.8989317995069844	exomes
global_rank	NA12878	RF	False	348	88.0	0.10011728433484413	0.10479535511994487	20	0	20	0	2724	2188	382	246	33	0.8513618677042801	0.8989317995069844	exomes
global_rank	NA12878	RF	False	352	89.0	0.08975564376933988	0.09347325442345225	3	0	3	0	2727	2188	385	246	30	0.8503692188107268	0.8989317995069844	exomes
global_rank	NA12878	RF	False	356	90.0	0.08513232834572143	0.08643576474354364	2	0	2	0	2729	2188	387	246	28	0.8497087378640776	0.8989317995069844	exomes
global_rank	NA12878	RF	False	359	91.0	0.07015619202812373	0.07617627685563151	3	0	3	0	2732	2188	390	246	25	0.8487199379363848	0.8989317995069844	exomes
global_rank	NA12878	RF	False	363	92.0	0.05838764370464184	0.0668701037839364	3	0	3	0	2735	2188	393	246	22	0.8477334366524603	0.8989317995069844	exomes
global_rank	NA12878	RF	False	366	93.0	0.051260327722194014	0.05737125802534152	7	0	7	0	2742	2188	400	246	15	0.8454404945904173	0.8989317995069844	exomes
global_rank	NA12878	RF	False	370	94.0	0.04180114383390508	0.04743124625923323	6	0	6	0	2748	2188	406	246	9	0.843484965304549	0.8989317995069844	exomes
global_rank	NA12878	RF	False	374	95.0	0.03627802888199426	0.03630730222214464	2	0	2	0	2750	2188	408	246	7	0.8428351309707242	0.8989317995069844	exomes
global_rank	NA12878	RF	False	377	96.0	0.03362270376468276	0.03533064867933474	4	0	4	0	2754	2188	412	246	3	0.8415384615384616	0.8989317995069844	exomes
global_rank	NA12878	RF	False	383	98.0	0.024927281774009356	0.027139044713818648	3	0	3	0	2757	2188	415	246	0	0.8405685747214752	0.8989317995069844	exomes
global_rank	NA12878	RF	False	389	-1.0	-1.0	-1.0	92	0	0	92	2849	2188	415	246	0	0.8405685747214752	0.8989317995069844	exomes
global_rank	NA12878	RF	True	393	0.0	0.940326909875765	0.940326909875765	12414	12326	0	88	12414	12326	0	26048	339	1.0	0.321207067285141	exomes
global_rank	NA12878	RF	True	397	1.0	0.9395401180862586	0.940326909875765	1156	1133	0	23	13570	13459	0	24915	339	1.0	0.3507322666388701	exomes
global_rank	NA12878	RF	True	401	2.0	0.9393634327490663	0.9395401180862586	528	525	0	3	14098	13984	0	24390	339	1.0	0.3644134049095742	exomes
global_rank	NA12878	RF	True	405	3.0	0.9388581575192725	0.9393634327490663	3606	3598	0	8	17704	17582	0	20792	339	1.0	0.45817480585813314	exomes
global_rank	NA12878	RF	True	409	4.0	0.9374117055303784	0.9388581575192725	131	128	0	3	17835	17710	0	20664	339	1.0	0.4615103976650857	exomes
global_rank	NA12878	RF	True	413	5.0	0.9359289229606387	0.9370704844796455	242	236	0	6	18077	17946	0	20428	339	1.0	0.46766039505915463	exomes
global_rank	NA12878	RF	True	417	6.0	0.934331965471451	0.9359289229606387	141	130	0	11	18218	18076	0	20298	339	1.0	0.4710481054880909	exomes
global_rank	NA12878	RF	True	421	7.0	0.9321719802867373	0.934092490892639	139	134	0	5	18357	18210	0	20164	339	1.0	0.4745400531609944	exomes
global_rank	NA12878	RF	True	425	8.0	0.9314429656249819	0.931852960191349	45	40	1	4	18402	18250	1	20124	338	0.9999452084817271	0.4755824256006671	exomes
global_rank	NA12878	RF	True	429	9.0	0.9297367653476872	0.9311872810237413	12	10	0	2	18414	18260	1	20114	338	0.9999452384863917	0.4758430187105853	exomes
global_rank	NA12878	RF	True	433	10.0	0.9282197755617577	0.9294749021771662	65	63	0	2	18479	18323	1	20051	338	0.9999454267627156	0.4774847553030698	exomes
global_rank	NA12878	RF	True	437	11.0	0.9264294232688725	0.9274199866805862	139	137	1	1	18618	18460	2	19914	337	0.9998916693749323	0.48105488090894877	exomes
global_rank	NA12878	RF	True	441	12.0	0.9246641508428851	0.9256748570719017	6367	6290	0	77	24985	24750	2	13624	337	0.9999191984486102	0.6449679470474801	exomes
global_rank	NA12878	RF	True	445	13.0	0.923196740432898	0.9246006189614459	2619	2573	0	46	27604	27323	2	11051	337	0.9999268069533395	0.7120185542294262	exomes
global_rank	NA12878	RF	True	449	14.0	0.9200578393171076	0.923168307343855	92	88	0	4	27696	27411	2	10963	337	0.9999270419144202	0.7143117735967061	exomes
global_rank	NA12878	RF	True	453	15.0	0.9167717722468406	0.9191790550491623	1927	1907	0	20	29623	29318	2	9056	337	0.9999317871759891	0.7640068796581019	exomes
global_rank	NA12878	RF	True	457	16.0	0.9113332661569825	0.9166262741316343	920	854	0	66	30543	30172	2	8202	337	0.9999337177702657	0.7862615312451139	exomes
global_rank	NA12878	RF	True	461	17.0	0.9066475624259768	0.9113332661569825	597	469	0	128	31140	30641	2	7733	337	0.9999347322390105	0.7984833481002762	exomes
global_rank	NA12878	RF	True	465	18.0	0.9025172758025951	0.9064970800449058	1397	1384	2	11	32537	32025	4	6349	335	0.9998751131786818	0.8345494345129515	exomes
global_rank	NA12878	RF	True	469	19.0	0.8976598203943466	0.9024125083783043	911	867	0	44	33448	32892	4	5482	335	0.9998784046692607	0.8571428571428571	exomes
global_rank	NA12878	RF	True	473	20.0	0.8860019207275962	0.8971935996235294	310	299	0	11	33758	33191	4	5183	335	0.9998794999246875	0.8649345911294105	exomes
global_rank	NA12878	RF	True	477	21.0	0.8774697696124741	0.8860019207275962	434	418	0	16	34192	33609	4	4765	335	0.9998809984232291	0.8758273831239902	exomes
global_rank	NA12878	RF	True	481	22.0	0.8728822521677381	0.8772239100173626	123	119	0	4	34315	33728	4	4646	335	0.999881418237875	0.8789284411320165	exomes
global_rank	NA12878	RF	True	485	23.0	0.8708496590019882	0.8727814567738787	177	172	0	5	34492	33900	4	4474	335	0.9998820198206702	0.883410642622609	exomes
global_rank	NA12878	RF	True	489	24.0	0.8686603267061266	0.8707228452553336	62	59	0	3	34554	33959	4	4415	335	0.9998822247740188	0.8849481419711263	exomes
global_rank	NA12878	RF	True	493	25.0	0.8670129632172343	0.8685675120962616	170	166	0	4	34724	34125	4	4249	335	0.9998827976207917	0.8892739875957679	exomes
global_rank	NA12878	RF	True	497	26.0	0.8657201323947327	0.8669186076646823	231	229	0	2	34955	34354	4	4020	335	0.9998835787880552	0.8952415698128942	exomes
global_rank	NA12878	RF	True	501	27.0	0.8640552574099686	0.8656949435934119	42	41	0	1	34997	34395	4	3979	335	0.9998837175499288	0.8963100015635587	exomes
global_rank	NA12878	RF	True	505	28.0	0.8625355220735323	0.863843263357738	299	294	0	5	35296	34689	4	3685	335	0.9998847029660162	0.903971438995153	exomes
global_rank	NA12878	RF	True	509	29.0	0.8603425301796809	0.8624932644117593	75	74	0	1	35371	34763	4	3611	335	0.9998849483705813	0.9058998280085474	exomes
global_rank	NA12878	RF	True	513	30.0	0.8580852730428525	0.8602960601356202	92	90	0	2	35463	34853	4	3521	335	0.9998852454313337	0.908245165997811	exomes
global_rank	NA12878	RF	True	517	31.0	0.8553837790888831	0.8580528390365781	377	368	0	9	35840	35221	4	3153	335	0.9998864442867281	0.9178349924427998	exomes
global_rank	NA12878	RF	True	521	32.0	0.8534062891805315	0.8552895174492354	60	58	0	2	35900	35279	4	3095	335	0.9998866309554176	0.9193464324803252	exomes
global_rank	NA12878	RF	True	525	33.0	0.851345467577701	0.8532141627409056	108	106	0	2	36008	35385	4	2989	335	0.999886970527565	0.9221087194454579	exomes
global_rank	NA12878	RF	True	529	34.0	0.8490444791895527	0.8511405379100642	54	53	0	1	36062	35438	4	2936	335	0.999887139551944	0.9234898629280242	exomes
global_rank	NA12878	RF	True	533	35.0	0.8469001027249926	0.8489215121778043	53	51	0	2	36115	35489	4	2885	335	0.9998873017214662	0.9248188877886069	exomes
global_rank	NA12878	RF	True	537	36.0	0.8434185236999582	0.8468490680338431	104	96	0	8	36219	35585	4	2789	335	0.9998876057208688	0.9273205816438214	exomes
global_rank	NA12878	RF	True	541	37.0	0.838695725683833	0.8428952215587417	208	203	0	5	36427	35788	4	2586	335	0.9998882431828342	0.9326106217751603	exomes
global_rank	NA12878	RF	True	545	38.0	0.835048707099408	0.8386138657063256	168	164	0	4	36595	35952	4	2422	335	0.9998887529202358	0.9368843487778183	exomes
global_rank	NA12878	RF	True	549	39.0	0.8316740877879453	0.8348143134449484	91	82	2	7	36686	36034	6	2340	333	0.9998335183129856	0.9390212122791474	exomes
global_rank	NA12878	RF	True	553	40.0	0.8286895345339564	0.8313826054282036	60	55	0	5	36746	36089	6	2285	333	0.9998337719905804	0.9404544743836973	exomes
global_rank	NA12878	RF	True	557	41.0	0.8257464552137123	0.8285681149953291	65	59	0	6	36811	36148	6	2226	333	0.9998340432593904	0.9419919737322145	exomes
global_rank	NA12878	RF	True	561	42.0	0.8224030096762346	0.8256565399404522	158	127	0	31	36969	36275	6	2099	333	0.9998346241834569	0.9453015062281753	exomes
global_rank	NA12878	RF	True	565	43.0	0.8194229965369867	0.8223544903524868	61	59	1	1	37030	36334	7	2040	332	0.9998073800941086	0.9468390055766925	exomes
global_rank	NA12878	RF	True	569	44.0	0.8160001920233154	0.8193479011652605	99	91	1	7	37129	36425	8	1949	331	0.9997804188510416	0.9492104028769479	exomes
global_rank	NA12878	RF	True	573	45.0	0.8122801323239254	0.8158411355382083	55	49	0	6	37184	36474	8	1900	331	0.999780713776657	0.950487309115547	exomes
global_rank	NA12878	RF	True	577	46.0	0.8081767000323323	0.8121065436912716	101	72	0	29	37285	36546	8	1828	331	0.9997811457022487	0.9523635795069578	exomes
global_rank	NA12878	RF	True	581	47.0	0.8039694354823428	0.8079396893235344	105	103	0	2	37390	36649	8	1725	331	0.9997817606459884	0.955047688539115	exomes
global_rank	NA12878	RF	True	585	48.0	0.7998483187375126	0.8038891937199403	57	50	1	6	37447	36699	9	1675	330	0.9997548218372017	0.9563506540887059	exomes
global_rank	NA12878	RF	True	589	49.0	0.7956589142966305	0.7998381472898382	50	47	0	3	37497	36746	9	1628	330	0.9997551353557339	0.9575754417053213	exomes
global_rank	NA12878	RF	True	593	50.0	0.7910632060043697	0.7956116311464976	51	48	1	2	37548	36794	10	1580	329	0.9997282904032171	0.9588262886329285	exomes
global_rank	NA12878	RF	True	597	51.0	0.7864170300171239	0.790585481828881	34	33	0	1	37582	36827	10	1547	329	0.9997285338111138	0.9596862458956585	exomes
global_rank	NA12878	RF	True	601	52.0	0.7823753883944519	0.7862878122418462	28	25	0	3	37610	36852	10	1522	329	0.9997287179208941	0.960337728670454	exomes
global_rank	NA12878	RF	True	604	53.0	0.7783895713567687	0.7820452767436187	25	20	2	3	37635	36872	12	1502	327	0.9996746556772584	0.9608589148902903	exomes
global_rank	NA12878	RF	True	608	54.0	0.7741834831608301	0.7778598145285442	22	22	0	0	37657	36894	12	1480	327	0.9996748496179483	0.9614322197321102	exomes
global_rank	NA12878	RF	True	611	55.0	0.7690810602586554	0.7731998016888689	25	24	0	1	37682	36918	12	1456	327	0.9996750609260764	0.9620576431959139	exomes
global_rank	NA12878	RF	True	615	56.0	0.7637290782646439	0.7686633588803545	21	18	2	1	37703	36936	14	1438	325	0.9996211096075778	0.9625267107937666	exomes
global_rank	NA12878	RF	True	618	57.0	0.7585540311094766	0.7636210192851054	22	21	0	1	37725	36957	14	1417	325	0.9996213248221579	0.9630739563245948	exomes
global_rank	NA12878	RF	True	622	58.0	0.7521317170046011	0.7579227227487361	25	22	1	2	37750	36979	15	1395	324	0.999594528842515	0.9636472611664147	exomes
global_rank	NA12878	RF	True	626	59.0	0.7443369093433723	0.7515530822659072	19	15	0	4	37769	36994	15	1380	324	0.9995946931827393	0.9640381508312921	exomes
global_rank	NA12878	RF	True	630	60.0	0.7371091909734588	0.7441062412585776	13	12	0	1	37782	37006	15	1368	324	0.999594824559034	0.9643508625631938	exomes
global_rank	NA12878	RF	True	634	61.0	0.7294730933569218	0.7363226931143945	26	22	0	4	37808	37028	15	1346	324	0.9995950651945037	0.9649241674050139	exomes
global_rank	NA12878	RF	True	638	62.0	0.7216855605241297	0.7287320109717481	11	11	0	0	37819	37039	15	1335	324	0.9995951854050845	0.9652108198259238	exomes
global_rank	NA12878	RF	True	642	63.0	0.7109656436926207	0.7207055572852512	8	8	0	0	37827	37047	15	1327	324	0.9995952727861421	0.9654192943138583	exomes
global_rank	NA12878	RF	True	645	64.0	0.7028852855829835	0.7097316569486957	9	7	0	2	37836	37054	15	1320	324	0.9995953492136287	0.965601709490801	exomes
global_rank	NA12878	RF	True	649	65.0	0.6908645539907915	0.7011415666936396	13	11	1	1	37849	37065	16	1309	323	0.999568512176047	0.965888361911711	exomes
global_rank	NA12878	RF	True	653	66.0	0.6776582663273053	0.6888427264033136	10	8	1	1	37859	37073	17	1301	322	0.9995416554327312	0.9660968363996456	exomes
global_rank	NA12878	RF	True	657	67.0	0.6664835890584812	0.6766411078023006	42	42	0	0	37901	37115	17	1259	322	0.999542173866207	0.9671913274613019	exomes
global_rank	NA12878	RF	True	661	68.0	0.6500203230005238	0.6638537082601076	12	11	1	0	37913	37126	18	1248	321	0.9995153995261684	0.967477979882212	exomes
global_rank	NA12878	RF	True	665	69.0	0.623152158516693	0.6473400667396451	14	9	0	5	37927	37135	18	1239	321	0.9995155169165343	0.9677125136811383	exomes
global_rank	NA12878	RF	True	669	70.0	0.5903237670170691	0.6204004504136669	36	27	0	9	37963	37162	18	1212	321	0.999515868746638	0.9684161150779174	exomes
global_rank	NA12878	RF	True	673	71.0	0.5687200713439434	0.5840393542137824	36	34	0	2	37999	37196	18	1178	321	0.9995163110657279	0.9693021316516391	exomes
global_rank	NA12878	RF	True	677	72.0	0.5478213867491496	0.5654965231064991	44	31	0	13	38043	37227	18	1147	321	0.9995167136528393	0.9701099702923854	exomes
global_rank	NA12878	RF	True	681	73.0	0.5253816630851292	0.547517413586684	55	40	0	15	38098	37267	18	1107	321	0.9995172321308837	0.9711523427320582	exomes
global_rank	NA12878	RF	True	685	74.0	0.5039690664115545	0.52450181608565	34	28	1	5	38132	37295	19	1079	320	0.9994908077397223	0.971882003439829	exomes
global_rank	NA12878	RF	True	689	75.0	0.4869547505444532	0.5039102615061113	55	36	3	16	38187	37331	22	1043	317	0.9994110245495677	0.9728201386355345	exomes
global_rank	NA12878	RF	True	693	76.0	0.4666432140106638	0.4850783247057897	33	21	3	9	38220	37352	25	1022	314	0.9993311394707975	0.9733673841663626	exomes
global_rank	NA12878	RF	True	696	77.0	0.4440228092566856	0.4656579856871482	33	18	2	13	38253	37370	27	1004	312	0.9992780169532316	0.9738364517642154	exomes
global_rank	NA12878	RF	True	700	78.0	0.4169735656825331	0.43986144806882044	21	9	1	11	38274	37379	28	995	311	0.9992514769962841	0.9740709855631418	exomes
global_rank	NA12878	RF	True	704	79.0	0.3909223182046334	0.4157264422047731	23	9	9	5	38297	37388	37	986	302	0.9990113560454242	0.9743055193620681	exomes
global_rank	NA12878	RF	True	707	80.0	0.35967952809043807	0.3904329915197625	28	19	2	7	38325	37407	39	967	300	0.998958500240346	0.9748006462709126	exomes
global_rank	NA12878	RF	True	711	81.0	0.3178141480346269	0.3585455393267718	31	21	9	1	38356	37428	48	946	291	0.9987191802753762	0.9753478918017408	exomes
global_rank	NA12878	RF	True	715	82.0	0.2953981572653605	0.3170219769188854	7	5	1	1	38363	37433	49	941	290	0.9986927058321328	0.9754781883566999	exomes
global_rank	NA12878	RF	True	719	83.0	0.2488788624359912	0.2775152443242201	10	3	2	5	38373	37436	51	938	288	0.9986395283698348	0.9755563662896753	exomes
global_rank	NA12878	RF	True	723	84.0	0.2170696017388522	0.24606262087445094	10	0	8	2	38383	37436	59	938	280	0.9984264568609148	0.9755563662896753	exomes
global_rank	NA12878	RF	True	727	85.0	0.1912126441029775	0.21574576655459088	22	10	10	2	38405	37446	69	928	270	0.9981607357057177	0.9758169593995935	exomes
global_rank	NA12878	RF	True	731	86.0	0.15888390325798865	0.18515757832253155	22	0	19	3	38427	37446	88	928	251	0.9976554590504609	0.9758169593995935	exomes
global_rank	NA12878	RF	True	735	87.0	0.13696638784138065	0.1557008708055502	19	3	14	2	38446	37449	102	925	237	0.9972836941759208	0.9758951373325689	exomes
global_rank	NA12878	RF	True	739	88.0	0.11432412956052622	0.13503816534069366	24	2	21	1	38470	37451	123	923	216	0.9967264597860223	0.9759472559545526	exomes
global_rank	NA12878	RF	True	743	89.0	0.09709517826615938	0.11393618072023796	21	2	18	1	38491	37453	141	921	198	0.9962494015002394	0.9759993745765362	exomes
global_rank	NA12878	RF	True	747	90.0	0.0814952169716886	0.09632271925301622	39	1	37	1	38530	37454	178	920	161	0.9952699829931972	0.976025433887528	exomes
global_rank	NA12878	RF	True	751	91.0	0.06551161317993	0.08097911532496112	27	1	26	0	38557	37455	204	919	135	0.9945829682147693	0.9760514931985198	exomes
global_rank	NA12878	RF	True	755	92.0	0.04934041584666141	0.061727770256087555	25	0	24	1	38582	37455	228	919	111	0.9939495263115994	0.9760514931985198	exomes
global_rank	NA12878	RF	True	759	93.0	0.041644137320141425	0.04890601554885046	24	0	23	1	38606	37455	251	919	88	0.9933432344984883	0.9760514931985198	exomes
global_rank	NA12878	RF	True	763	94.0	0.035912067210497244	0.04146948976603198	25	0	25	0	38631	37455	276	919	63	0.9926850600302138	0.9760514931985198	exomes
global_rank	NA12878	RF	True	767	95.0	0.031027662559899315	0.035739211065497	17	0	17	0	38648	37455	293	919	46	0.9922379993642048	0.9760514931985198	exomes
global_rank	NA12878	RF	True	771	96.0	0.025468652021388514	0.02998696524767194	10	0	10	0	38658	37455	303	919	36	0.9919752105514064	0.9760514931985198	exomes
global_rank	NA12878	RF	True	775	97.0	0.021390042810200273	0.025237410639511473	12	0	12	0	38670	37455	315	919	24	0.9916600476568705	0.9760514931985198	exomes
global_rank	NA12878	RF	True	779	98.0	0.01690375169193909	0.01996114825265465	20	0	19	1	38690	37455	334	919	5	0.9911614490989441	0.9760514931985198	exomes
global_rank	NA12878	RF	True	783	99.0	0.009049676032541273	0.016732141557160185	5	0	5	0	38695	37455	339	919	0	0.9910303222733767	0.9760514931985198	exomes
global_rank	NA12878	RF	True	787	-1.0	-1.0	-1.0	18	0	0	18	38713	37455	339	919	0	0.9910303222733767	0.9760514931985198	exomes
global_rank	NA12878	VQSR	False	1	0.0	6.1	7.64	722	697	12	13	722	697	12	1737	403	0.9830747531734838	0.28635990139687756	exomes
global_rank	NA12878	VQSR	False	5	1.0	5.9	6.1	80	75	2	3	802	772	14	1662	401	0.9821882951653944	0.3171733771569433	exomes
global_rank	NA12878	VQSR	False	8	2.0	5.73	5.89	91	85	3	3	893	857	17	1577	398	0.9805491990846682	0.35209531635168445	exomes
global_rank	NA12878	VQSR	False	12	3.0	5.57	5.73	65	60	3	2	958	917	20	1517	395	0.9786552828175027	0.37674609695973704	exomes
global_rank	NA12878	VQSR	False	16	4.0	5.39	5.57	66	63	2	1	1024	980	22	1454	393	0.9780439121756487	0.4026294165981923	exomes
global_rank	NA12878	VQSR	False	20	5.0	5.2	5.39	67	65	2	0	1091	1045	24	1389	391	0.9775491113189897	0.4293344289235826	exomes
global_rank	NA12878	VQSR	False	24	6.0	4.98	5.19	59	54	3	2	1150	1099	27	1335	388	0.9760213143872114	0.4515201314708299	exomes
global_rank	NA12878	VQSR	False	28	7.0	4.74	4.98	61	56	5	0	1211	1155	32	1279	383	0.9730412805391744	0.4745275267050123	exomes
global_rank	NA12878	VQSR	False	32	8.0	4.54	4.73	44	39	4	1	1255	1194	36	1240	379	0.9707317073170731	0.4905505341002465	exomes
global_rank	NA12878	VQSR	False	36	9.0	4.35	4.53	65	58	6	1	1320	1252	42	1182	373	0.9675425038639877	0.514379622021364	exomes
global_rank	NA12878	VQSR	False	40	10.0	4.18	4.35	83	73	7	3	1403	1325	49	1109	366	0.9643377001455604	0.5443714050944947	exomes
global_rank	NA12878	VQSR	False	44	11.0	4.01	4.18	86	76	4	6	1489	1401	53	1033	362	0.9635488308115543	0.575595727198028	exomes
global_rank	NA12878	VQSR	False	48	12.0	3.84	4.01	53	45	4	4	1542	1446	57	988	358	0.9620758483033932	0.5940838126540674	exomes
global_rank	NA12878	VQSR	False	52	13.0	3.68	3.84	61	52	4	5	1603	1498	61	936	354	0.9608723540731238	0.6154478225143796	exomes
global_rank	NA12878	VQSR	False	56	14.0	3.51	3.67	59	44	9	6	1662	1542	70	892	345	0.956575682382134	0.6335250616269515	exomes
global_rank	NA12878	VQSR	False	60	15.0	3.36	3.51	55	34	17	4	1717	1576	87	858	328	0.9476849067949489	0.647493837304848	exomes
global_rank	NA12878	VQSR	False	64	16.0	3.21	3.36	68	37	28	3	1785	1613	115	821	300	0.9334490740740741	0.6626951520131471	exomes
global_rank	NA12878	VQSR	False	68	17.0	3.08	3.21	64	38	26	0	1849	1651	141	783	274	0.9213169642857143	0.6783073130649138	exomes
global_rank	NA12878	VQSR	False	72	18.0	3.0	3.08	44	27	15	2	1893	1678	156	756	259	0.9149400218102508	0.6894001643385373	exomes
global_rank	NA12878	VQSR	False	76	19.0	2.94	3.0	29	14	14	1	1922	1692	170	742	245	0.9087003222341569	0.695152013147083	exomes
global_rank	NA12878	VQSR	False	80	20.0	2.87	2.93	26	17	7	2	1948	1709	177	725	238	0.9061505832449629	0.7021364009860313	exomes
global_rank	NA12878	VQSR	False	84	21.0	2.81	2.87	28	19	8	1	1976	1728	185	706	230	0.9032932566649242	0.7099424815119145	exomes
global_rank	NA12878	VQSR	False	88	22.0	2.73	2.8	30	15	10	5	2006	1743	195	691	220	0.8993808049535603	0.7161051766639277	exomes
global_rank	NA12878	VQSR	False	92	23.0	2.66	2.73	23	15	5	3	2029	1758	200	676	215	0.8978549540347294	0.7222678718159409	exomes
global_rank	NA12878	VQSR	False	96	24.0	2.58	2.65	28	22	5	1	2057	1780	205	654	210	0.8967254408060453	0.7313064913722268	exomes
global_rank	NA12878	VQSR	False	100	25.0	2.51	2.58	23	13	9	1	2080	1793	214	641	201	0.8933731938216243	0.7366474938373049	exomes
global_rank	NA12878	VQSR	False	104	26.0	2.44	2.5	13	8	2	3	2093	1801	216	633	199	0.8929102627664849	0.7399342645850452	exomes
global_rank	NA12878	VQSR	False	108	27.0	2.36	2.42	17	13	3	1	2110	1814	219	620	196	0.8922774225282833	0.7452752670501233	exomes
global_rank	NA12878	VQSR	False	112	28.0	2.31	2.35	11	4	3	4	2121	1818	222	616	193	0.8911764705882353	0.7469186524239935	exomes
global_rank	NA12878	VQSR	False	116	29.0	2.23	2.29	18	14	3	1	2139	1832	225	602	190	0.8906174039863879	0.752670501232539	exomes
global_rank	NA12878	VQSR	False	120	30.0	2.17	2.22	15	11	2	2	2154	1843	227	591	188	0.8903381642512077	0.7571898110106821	exomes
global_rank	NA12878	VQSR	False	124	31.0	2.11	2.16	20	14	4	2	2174	1857	231	577	184	0.889367816091954	0.7629416598192276	exomes
global_rank	NA12878	VQSR	False	128	32.0	2.05	2.1	16	11	2	3	2190	1868	233	566	182	0.8891004283674441	0.7674609695973705	exomes
global_rank	NA12878	VQSR	False	132	33.0	2.01	2.05	14	7	4	3	2204	1875	237	559	178	0.8877840909090909	0.7703368940016434	exomes
global_rank	NA12878	VQSR	False	136	34.0	1.94	1.99	13	10	1	2	2217	1885	238	549	177	0.8878944889307584	0.7744453574363188	exomes
global_rank	NA12878	VQSR	False	140	35.0	1.9	1.94	13	7	1	5	2230	1892	239	542	176	0.8878460816518067	0.7773212818405916	exomes
global_rank	NA12878	VQSR	False	144	36.0	1.83	1.88	17	16	1	0	2247	1908	240	526	175	0.888268156424581	0.7838948233360723	exomes
global_rank	NA12878	VQSR	False	148	37.0	1.77	1.82	10	8	1	1	2257	1916	241	518	174	0.8882707464070468	0.7871815940838126	exomes
global_rank	NA12878	VQSR	False	152	38.0	1.73	1.77	12	7	3	2	2269	1923	244	511	171	0.8874019381633594	0.7900575184880855	exomes
global_rank	NA12878	VQSR	False	156	39.0	1.65	1.71	13	12	0	1	2282	1935	244	499	171	0.888022028453419	0.794987674609696	exomes
global_rank	NA12878	VQSR	False	160	40.0	1.59	1.64	14	9	4	1	2296	1944	248	490	167	0.8868613138686131	0.7986852917009039	exomes
global_rank	NA12878	VQSR	False	164	41.0	1.51	1.57	19	16	2	1	2315	1960	250	474	165	0.8868778280542986	0.8052588331963846	exomes
global_rank	NA12878	VQSR	False	168	42.0	1.45	1.5	13	12	0	1	2328	1972	250	462	165	0.8874887488748875	0.8101889893179951	exomes
global_rank	NA12878	VQSR	False	172	43.0	1.38	1.44	29	25	2	2	2357	1997	252	437	163	0.8879502000889284	0.8204601479046837	exomes
global_rank	NA12878	VQSR	False	176	44.0	1.31	1.37	36	28	6	2	2393	2025	258	409	157	0.8869908015768725	0.8319638455217748	exomes
global_rank	NA12878	VQSR	False	180	45.0	1.24	1.31	29	20	5	4	2422	2045	263	389	152	0.8860485268630849	0.8401807723911258	exomes
global_rank	NA12878	VQSR	False	184	46.0	1.17	1.24	29	25	3	1	2451	2070	266	364	149	0.8861301369863014	0.8504519309778144	exomes
global_rank	NA12878	VQSR	False	188	47.0	1.12	1.17	20	10	9	1	2471	2080	275	354	140	0.8832271762208068	0.8545603944124898	exomes
global_rank	NA12878	VQSR	False	192	48.0	1.08	1.12	25	7	16	2	2496	2087	291	347	124	0.8776282590412111	0.8574363188167625	exomes
global_rank	NA12878	VQSR	False	196	49.0	1.03	1.07	13	6	6	1	2509	2093	297	341	118	0.8757322175732217	0.8599013968775678	exomes
global_rank	NA12878	VQSR	False	200	50.0	0.995	1.03	15	3	9	3	2524	2096	306	338	109	0.8726061615320566	0.8611339359079704	exomes
global_rank	NA12878	VQSR	False	204	51.0	0.955	0.987	8	5	3	0	2532	2101	309	333	106	0.8717842323651452	0.8631881676253081	exomes
global_rank	NA12878	VQSR	False	208	52.0	0.921	0.95	6	5	1	0	2538	2106	310	328	105	0.8716887417218543	0.8652423993426458	exomes
global_rank	NA12878	VQSR	False	212	53.0	0.87	0.903	10	5	5	0	2548	2111	315	323	100	0.870156636438582	0.8672966310599836	exomes
global_rank	NA12878	VQSR	False	216	54.0	0.834	0.855	4	2	1	1	2552	2113	316	321	99	0.869905310827501	0.8681183237469187	exomes
global_rank	NA12878	VQSR	False	220	55.0	0.786	0.825	8	3	4	1	2560	2116	320	318	95	0.8686371100164204	0.8693508627773213	exomes
global_rank	NA12878	VQSR	False	224	56.0	0.741	0.771	6	2	3	1	2566	2118	323	316	92	0.8676771814829988	0.8701725554642563	exomes
global_rank	NA12878	VQSR	False	228	57.0	0.721	0.737	2	2	0	0	2568	2120	323	314	92	0.8677855096193205	0.8709942481511914	exomes
global_rank	NA12878	VQSR	False	232	58.0	0.665	0.691	3	1	1	1	2571	2121	324	313	91	0.8674846625766871	0.871405094494659	exomes
global_rank	NA12878	VQSR	False	236	59.0	0.606	0.647	7	4	3	0	2578	2125	327	309	88	0.8666394779771615	0.8730484798685292	exomes
global_rank	NA12878	VQSR	False	240	60.0	0.553	0.598	4	2	1	1	2582	2127	328	307	87	0.8663951120162933	0.8738701725554643	exomes
global_rank	NA12878	VQSR	False	244	61.0	0.499	0.541	6	3	2	1	2588	2130	330	304	85	0.8658536585365854	0.8751027115858668	exomes
global_rank	NA12878	VQSR	False	248	62.0	0.473	0.482	2	1	1	0	2590	2131	331	303	84	0.8655564581640942	0.8755135579293344	exomes
global_rank	NA12878	VQSR	False	252	63.0	0.386	0.443	6	5	0	1	2596	2136	331	298	84	0.8658289420348602	0.8775677896466721	exomes
global_rank	NA12878	VQSR	False	256	64.0	0.333	0.384	6	5	1	0	2602	2141	332	293	83	0.8657501010917914	0.8796220213640099	exomes
global_rank	NA12878	VQSR	False	260	65.0	0.272	0.303	3	1	1	1	2605	2142	333	292	82	0.8654545454545455	0.8800328677074774	exomes
global_rank	NA12878	VQSR	False	264	66.0	0.22	0.243	4	3	1	0	2609	2145	334	289	81	0.8652682533279549	0.88126540673788	exomes
global_rank	NA12878	VQSR	False	268	67.0	0.124	0.176	8	3	5	0	2617	2148	339	286	76	0.8636911942098915	0.8824979457682827	exomes
global_rank	NA12878	VQSR	False	272	68.0	0.051	0.123	7	2	4	1	2624	2150	343	284	72	0.8624147613317288	0.8833196384552178	exomes
global_rank	NA12878	VQSR	False	276	69.0	-0.0097	0.048	7	3	3	1	2631	2153	346	281	69	0.8615446178471389	0.8845521774856204	exomes
global_rank	NA12878	VQSR	False	280	70.0	-0.1022	-0.0462	5	2	1	2	2636	2155	347	279	68	0.8613109512390088	0.8853738701725554	exomes
global_rank	NA12878	VQSR	False	284	71.0	-0.1793	-0.1318	5	2	0	3	2641	2157	347	277	68	0.8614217252396166	0.8861955628594905	exomes
global_rank	NA12878	VQSR	False	288	72.0	-0.2515	-0.1851	10	5	2	3	2651	2162	349	272	66	0.8610115491835922	0.8882497945768283	exomes
global_rank	NA12878	VQSR	False	292	73.0	-0.327	-0.261	9	3	0	6	2660	2165	349	269	66	0.8611774065234685	0.889482333607231	exomes
global_rank	NA12878	VQSR	False	296	74.0	-0.4036	-0.3471	5	2	1	2	2665	2167	350	267	65	0.8609455701231625	0.8903040262941659	exomes
global_rank	NA12878	VQSR	False	300	75.0	-0.4795	-0.4187	6	2	1	3	2671	2169	351	265	64	0.8607142857142858	0.891125718981101	exomes
global_rank	NA12878	VQSR	False	304	76.0	-0.5684	-0.5033	3	1	1	1	2674	2170	352	264	63	0.8604282315622522	0.8915365653245686	exomes
global_rank	NA12878	VQSR	False	308	77.0	-0.6216	-0.5942	2	2	0	0	2676	2172	352	262	63	0.8605388272583201	0.8923582580115037	exomes
global_rank	NA12878	VQSR	False	312	78.0	-0.6781	-0.6643	2	0	1	1	2678	2172	353	262	62	0.8601980198019802	0.8923582580115037	exomes
global_rank	NA12878	VQSR	False	316	79.0	-0.7611	-0.7611	1	1	0	0	2679	2173	353	261	62	0.8602533650039589	0.8927691043549713	exomes
global_rank	NA12878	VQSR	False	320	80.0	-0.8429	-0.8353	2	1	0	1	2681	2174	353	260	62	0.8603086664028492	0.8931799506984388	exomes
global_rank	NA12878	VQSR	False	324	81.0	-0.9204	-0.9204	1	1	0	0	2682	2175	353	259	62	0.8603639240506329	0.8935907970419064	exomes
global_rank	NA12878	VQSR	False	331	83.0	-1.126	-1.061	2	1	1	0	2684	2176	354	258	61	0.8600790513833992	0.8940016433853739	exomes
global_rank	NA12878	VQSR	False	338	85.0	-1.279	-1.279	1	1	0	0	2685	2177	354	257	61	0.8601343342552351	0.8944124897288415	exomes
global_rank	NA12878	VQSR	False	342	86.0	-1.486	-1.429	2	1	1	0	2687	2178	355	256	60	0.8598499802605606	0.8948233360723089	exomes
global_rank	NA12878	VQSR	False	345	87.0	-1.607	-1.519	5	1	4	0	2692	2179	359	255	56	0.8585500394011032	0.8952341824157765	exomes
global_rank	NA12878	VQSR	False	349	88.0	-1.726	-1.645	2	0	2	0	2694	2179	361	255	54	0.8578740157480315	0.8952341824157765	exomes
global_rank	NA12878	VQSR	False	353	89.0	-1.801	-1.801	1	0	1	0	2695	2179	362	255	53	0.8575364029909485	0.8952341824157765	exomes
global_rank	NA12878	VQSR	False	360	91.0	-2.15	-2.15	1	1	0	0	2696	2180	362	254	53	0.8575924468922108	0.895645028759244	exomes
global_rank	NA12878	VQSR	False	364	92.0	-2.254	-2.184	3	0	3	0	2699	2180	365	254	50	0.8565815324165029	0.895645028759244	exomes
global_rank	NA12878	VQSR	False	367	93.0	-2.461	-2.361	2	0	2	0	2701	2180	367	254	48	0.855908912446015	0.895645028759244	exomes
global_rank	NA12878	VQSR	False	371	94.0	-2.48	-2.48	1	0	1	0	2702	2180	368	254	47	0.8555729984301413	0.895645028759244	exomes
global_rank	NA12878	VQSR	False	380	97.0	-6.799	-6.799	1	0	1	0	2703	2180	369	254	46	0.8552373479795998	0.895645028759244	exomes
global_rank	NA12878	VQSR	False	384	98.0	-34.64	-8.603	21	1	20	0	2724	2181	389	253	26	0.8486381322957198	0.8960558751027116	exomes
global_rank	NA12878	VQSR	False	387	99.0	-185.5	-38.01	33	7	26	0	2757	2188	415	246	0	0.8405685747214752	0.8989317995069844	exomes
global_rank	NA12878	VQSR	False	390	-1.0	-1.0	-1.0	92	0	0	92	2849	2188	415	246	0	0.8405685747214752	0.8989317995069844	exomes
global_rank	NA12878	VQSR	True	394	0.0	5.71	9.0	17531	17503	1	27	17531	17503	1	20871	338	0.9999428702010968	0.45611612028977955	exomes
global_rank	NA12878	VQSR	True	398	1.0	5.19	5.71	5923	5896	3	24	23454	23399	4	14975	335	0.9998290817416571	0.6097618178975348	exomes
global_rank	NA12878	VQSR	True	402	2.0	4.72	5.19	3507	3476	0	31	26961	26875	4	11499	335	0.9998511849399159	0.700343982905092	exomes
global_rank	NA12878	VQSR	True	406	3.0	4.32	4.72	2078	2048	0	30	29039	28923	4	9451	335	0.9998617208836036	0.753713451816334	exomes
global_rank	NA12878	VQSR	True	410	4.0	4.0	4.32	1298	1269	0	29	30337	30192	4	8182	335	0.99986753212346	0.7867827174649502	exomes
global_rank	NA12878	VQSR	True	414	5.0	3.71	4.0	1128	1098	0	30	31465	31290	4	7084	335	0.9998721799706014	0.8153958409339657	exomes
global_rank	NA12878	VQSR	True	418	6.0	3.44	3.71	904	869	1	34	32369	32159	5	6215	334	0.9998445466981719	0.838041382185855	exomes
global_rank	NA12878	VQSR	True	422	7.0	3.2	3.44	799	766	1	32	33168	32925	6	5449	333	0.999817800856336	0.8580028144055871	exomes
global_rank	NA12878	VQSR	True	426	8.0	3.0	3.2	693	662	1	30	33861	33587	7	4787	332	0.9997916294576412	0.8752540782821702	exomes
global_rank	NA12878	VQSR	True	430	9.0	2.84	3.0	588	549	0	39	34449	34136	7	4238	332	0.9997949799373225	0.889560640016678	exomes
global_rank	NA12878	VQSR	True	434	10.0	2.68	2.84	406	381	1	24	34855	34517	8	3857	331	0.999768283852281	0.8994892375045603	exomes
global_rank	NA12878	VQSR	True	438	11.0	2.52	2.68	367	336	0	31	35222	34853	8	3521	331	0.9997705171968676	0.908245165997811	exomes
global_rank	NA12878	VQSR	True	442	12.0	2.37	2.52	323	283	0	40	35545	35136	8	3238	331	0.9997723651263374	0.9156199510084954	exomes
global_rank	NA12878	VQSR	True	446	13.0	2.22	2.36	289	245	1	43	35834	35381	9	2993	330	0.999745690873128	0.9220044822014906	exomes
global_rank	NA12878	VQSR	True	450	14.0	2.09	2.22	255	222	1	32	36089	35603	10	2771	329	0.9997192036615843	0.9277896492416741	exomes
global_rank	NA12878	VQSR	True	454	15.0	1.97	2.09	222	179	3	40	36311	35782	13	2592	326	0.9996368207850258	0.9324542659092093	exomes
global_rank	NA12878	VQSR	True	458	16.0	1.86	1.97	195	151	0	44	36506	35933	13	2441	326	0.9996383464085017	0.9363892218689738	exomes
global_rank	NA12878	VQSR	True	462	17.0	1.75	1.86	170	141	1	28	36676	36074	14	2300	325	0.9996120594103303	0.94006358471882	exomes
global_rank	NA12878	VQSR	True	466	18.0	1.64	1.75	162	132	0	30	36838	36206	14	2168	325	0.9996134732192159	0.9435034137697399	exomes
global_rank	NA12878	VQSR	True	470	19.0	1.54	1.64	165	136	1	28	37003	36342	15	2032	324	0.9995874247050086	0.9470474800646271	exomes
global_rank	NA12878	VQSR	True	474	20.0	1.44	1.54	169	137	0	32	37172	36479	15	1895	324	0.9995889735298953	0.9506176056705061	exomes
global_rank	NA12878	VQSR	True	478	21.0	1.33	1.44	150	128	2	20	37322	36607	17	1767	322	0.9995358235037134	0.9539531974774587	exomes
global_rank	NA12878	VQSR	True	482	22.0	1.23	1.33	128	105	1	22	37450	36712	18	1662	321	0.9995099373808876	0.9566894251315995	exomes
global_rank	NA12878	VQSR	True	486	23.0	1.13	1.23	131	110	0	21	37581	36822	18	1552	321	0.9995114006514658	0.9595559493406994	exomes
global_rank	NA12878	VQSR	True	490	24.0	1.03	1.13	106	83	0	23	37687	36905	18	1469	321	0.9995124989843729	0.9617188721530203	exomes
global_rank	NA12878	VQSR	True	494	25.0	0.943	1.03	94	70	0	24	37781	36975	18	1399	321	0.9995134214581137	0.9635430239224475	exomes
global_rank	NA12878	VQSR	True	498	26.0	0.86	0.937	73	56	2	15	37854	37031	20	1343	319	0.9994602035032792	0.9650023453379892	exomes
global_rank	NA12878	VQSR	True	502	27.0	0.781	0.852	60	51	0	9	37914	37082	20	1292	319	0.9994609455015903	0.966331370198572	exomes
global_rank	NA12878	VQSR	True	506	28.0	0.706	0.78	64	56	0	8	37978	37138	20	1236	319	0.9994617578987028	0.9677906916141137	exomes
global_rank	NA12878	VQSR	True	510	29.0	0.631	0.705	39	33	0	6	38017	37171	20	1203	319	0.9994622354870802	0.9686506488768437	exomes
global_rank	NA12878	VQSR	True	514	30.0	0.561	0.63	40	35	0	5	38057	37206	20	1168	319	0.9994627410949336	0.9695627247615574	exomes
global_rank	NA12878	VQSR	True	518	31.0	0.48	0.556	38	26	3	9	38095	37232	23	1142	316	0.9993826332035969	0.9702402668473445	exomes
global_rank	NA12878	VQSR	True	522	32.0	0.419	0.477	20	15	0	5	38115	37247	23	1127	316	0.9993828816742688	0.9706311565122219	exomes
global_rank	NA12878	VQSR	True	526	33.0	0.323	0.396	23	17	1	5	38138	37264	24	1110	315	0.9993563612958593	0.9710741647990827	exomes
global_rank	NA12878	VQSR	True	530	34.0	0.25	0.315	17	14	1	2	38155	37278	25	1096	314	0.9993298126156073	0.9714389951529682	exomes
global_rank	NA12878	VQSR	True	534	35.0	0.196	0.238	9	6	2	1	38164	37284	27	1090	312	0.9992763528182037	0.971595351018919	exomes
global_rank	NA12878	VQSR	True	538	36.0	0.122	0.16	7	5	2	0	38171	37289	29	1085	310	0.9992228951176376	0.9717256475738781	exomes
global_rank	NA12878	VQSR	True	542	37.0	0.084	0.118	9	8	0	1	38180	37297	29	1077	310	0.9992230616728286	0.9719341220618127	exomes
global_rank	NA12878	VQSR	True	546	38.0	0.034	0.063	8	7	0	1	38188	37304	29	1070	310	0.9992232073500656	0.9721165372387555	exomes
global_rank	NA12878	VQSR	True	550	39.0	-0.0118	0.017	11	9	1	1	38199	37313	30	1061	309	0.9991966365851699	0.9723510710376818	exomes
global_rank	NA12878	VQSR	True	554	40.0	-0.0432	-0.0148	8	4	1	3	38207	37317	31	1057	308	0.9991699689407733	0.9724553082816491	exomes
global_rank	NA12878	VQSR	True	558	41.0	-0.0654	-0.0471	4	3	0	1	38211	37320	31	1054	308	0.9991700356081498	0.9725334862146244	exomes
global_rank	NA12878	VQSR	True	562	42.0	-0.0928	-0.0774	5	3	0	2	38216	37323	31	1051	308	0.9991701022648177	0.9726116641475999	exomes
global_rank	NA12878	VQSR	True	566	43.0	-0.1239	-0.1122	4	3	1	0	38220	37326	32	1048	307	0.9991434230954548	0.9726898420805754	exomes
global_rank	NA12878	VQSR	True	570	44.0	-0.1519	-0.1519	1	1	0	0	38221	37327	32	1047	307	0.9991434460237159	0.9727159013915672	exomes
global_rank	NA12878	VQSR	True	574	45.0	-0.1864	-0.1844	2	1	0	1	38223	37328	32	1046	307	0.9991434689507495	0.972741960702559	exomes
global_rank	NA12878	VQSR	True	578	46.0	-0.2048	-0.1885	5	2	1	2	38228	37330	33	1044	306	0.999116773278377	0.9727940793245426	exomes
global_rank	NA12878	VQSR	True	582	47.0	-0.2377	-0.2178	5	4	1	0	38233	37334	34	1040	305	0.9990901305930208	0.9728983165685099	exomes
global_rank	NA12878	VQSR	True	586	48.0	-0.2613	-0.2382	6	3	0	3	38239	37337	34	1037	305	0.9990902036338337	0.9729764945014854	exomes
global_rank	NA12878	VQSR	True	590	49.0	-0.2799	-0.2788	2	1	0	1	38241	37338	34	1036	305	0.9990902279781655	0.9730025538124772	exomes
global_rank	NA12878	VQSR	True	594	50.0	-0.3059	-0.2887	2	0	0	2	38243	37338	34	1036	305	0.9990902279781655	0.9730025538124772	exomes
global_rank	NA12878	VQSR	True	598	51.0	-0.3362	-0.3279	3	1	2	0	38246	37339	36	1035	303	0.9990367892976588	0.973028613123469	exomes
global_rank	NA12878	VQSR	True	605	53.0	-0.3795	-0.3682	3	0	1	2	38249	37339	37	1035	302	0.9990100599315068	0.973028613123469	exomes
global_rank	NA12878	VQSR	True	612	55.0	-0.4349	-0.4252	3	2	0	1	38252	37341	37	1033	302	0.9990101129006368	0.9730807317454526	exomes
global_rank	NA12878	VQSR	True	619	57.0	-0.4717	-0.4717	1	1	0	0	38253	37342	37	1032	302	0.999010139383076	0.9731067910564445	exomes
global_rank	NA12878	VQSR	True	623	58.0	-0.5128	-0.5128	1	0	1	0	38254	37342	38	1032	301	0.9989834135901552	0.9731067910564445	exomes
global_rank	NA12878	VQSR	True	627	59.0	-0.5483	-0.5219	5	1	0	4	38259	37343	38	1031	301	0.9989834407854258	0.9731328503674362	exomes
global_rank	NA12878	VQSR	True	631	60.0	-0.5782	-0.5568	2	1	1	0	38261	37344	39	1030	300	0.9989567450445389	0.9731589096784281	exomes
global_rank	NA12878	VQSR	True	635	61.0	-0.5921	-0.586	3	1	2	0	38264	37345	41	1029	298	0.9989033327983737	0.97318496898942	exomes
global_rank	NA12878	VQSR	True	639	62.0	-0.6238	-0.6238	1	1	0	0	38265	37346	41	1028	298	0.9989033621312221	0.9732110283004117	exomes
global_rank	NA12878	VQSR	True	646	64.0	-0.7045	-0.7045	1	0	0	1	38266	37346	41	1028	298	0.9989033621312221	0.9732110283004117	exomes
global_rank	NA12878	VQSR	True	650	65.0	-0.73	-0.7083	6	4	1	1	38272	37350	42	1024	297	0.9988767650834403	0.973315265544379	exomes
global_rank	NA12878	VQSR	True	654	66.0	-0.7747	-0.7438	4	1	1	2	38276	37351	43	1023	296	0.9988500829010002	0.9733413248553708	exomes
global_rank	NA12878	VQSR	True	658	67.0	-0.7897	-0.7897	1	0	1	0	38277	37351	44	1023	295	0.9988233721085706	0.9733413248553708	exomes
global_rank	NA12878	VQSR	True	662	68.0	-0.8511	-0.8474	2	2	0	0	38279	37353	44	1021	295	0.9988234350348959	0.9733934434773545	exomes
global_rank	NA12878	VQSR	True	666	69.0	-0.8891	-0.8555	2	0	2	0	38281	37353	46	1021	293	0.9987700205887858	0.9733934434773545	exomes
global_rank	NA12878	VQSR	True	670	70.0	-0.924	-0.8952	6	2	4	0	38287	37355	50	1019	289	0.998663280310119	0.9734455620993381	exomes
global_rank	NA12878	VQSR	True	674	71.0	-0.9696	-0.9392	2	2	0	0	38289	37357	50	1017	289	0.9986633517790788	0.9734976807213217	exomes
global_rank	NA12878	VQSR	True	678	72.0	-1.015	-0.9923	4	0	4	0	38293	37357	54	1017	285	0.9985565742695999	0.9734976807213217	exomes
global_rank	NA12878	VQSR	True	682	73.0	-1.058	-1.03	2	1	0	1	38295	37358	54	1016	285	0.9985566128514916	0.9735237400323136	exomes
global_rank	NA12878	VQSR	True	686	74.0	-1.07	-1.067	2	1	1	0	38297	37359	55	1015	284	0.9985299620462929	0.9735497993433053	exomes
global_rank	NA12878	VQSR	True	690	75.0	-1.15	-1.119	3	1	2	0	38300	37360	57	1014	282	0.9984766282705722	0.9735758586542972	exomes
global_rank	NA12878	VQSR	True	697	77.0	-1.211	-1.211	1	0	1	0	38301	37360	58	1014	281	0.9984499438772784	0.9735758586542972	exomes
global_rank	NA12878	VQSR	True	701	78.0	-1.301	-1.289	3	2	1	0	38304	37362	59	1012	280	0.9984233451805136	0.9736279772762808	exomes
global_rank	NA12878	VQSR	True	708	80.0	-1.412	-1.402	3	2	1	0	38307	37364	60	1010	279	0.998396750748183	0.9736800958982644	exomes
global_rank	NA12878	VQSR	True	712	81.0	-1.472	-1.449	2	0	2	0	38309	37364	62	1010	277	0.9983433976380056	0.9736800958982644	exomes
global_rank	NA12878	VQSR	True	716	82.0	-1.52	-1.52	1	1	0	0	38310	37365	62	1009	277	0.9983434419002325	0.9737061552092563	exomes
global_rank	NA12878	VQSR	True	720	83.0	-1.633	-1.568	5	2	2	1	38315	37367	64	1007	275	0.9982901872779247	0.9737582738312399	exomes
global_rank	NA12878	VQSR	True	724	84.0	-1.651	-1.651	1	0	1	0	38316	37367	65	1007	274	0.9982635178456936	0.9737582738312399	exomes
global_rank	NA12878	VQSR	True	728	85.0	-1.765	-1.76	2	0	2	0	38318	37367	67	1007	272	0.9982101832558636	0.9737582738312399	exomes
global_rank	NA12878	VQSR	True	732	86.0	-1.878	-1.819	4	2	2	0	38322	37369	69	1005	270	0.9981569528286768	0.9738103924532235	exomes
global_rank	NA12878	VQSR	True	736	87.0	-1.954	-1.885	3	0	3	0	38325	37369	72	1005	267	0.9980769744397853	0.9738103924532235	exomes
global_rank	NA12878	VQSR	True	740	88.0	-2.056	-1.993	8	2	5	1	38333	37371	77	1003	262	0.9979438154240546	0.9738625110752072	exomes
global_rank	NA12878	VQSR	True	744	89.0	-2.171	-2.072	6	2	4	0	38339	37373	81	1001	258	0.9978373471458323	0.9739146296971908	exomes
global_rank	NA12878	VQSR	True	748	90.0	-2.285	-2.192	6	1	4	1	38345	37374	85	1000	254	0.9977308523986225	0.9739406890081826	exomes
global_rank	NA12878	VQSR	True	752	91.0	-2.471	-2.314	7	2	3	2	38352	37376	88	998	251	0.9976510783685671	0.9739928076301663	exomes
global_rank	NA12878	VQSR	True	756	92.0	-2.679	-2.508	4	2	1	1	38356	37378	89	996	250	0.9976245762938052	0.9740449262521499	exomes
global_rank	NA12878	VQSR	True	760	93.0	-2.977	-2.698	15	6	7	2	38371	37384	96	990	243	0.9974386339381003	0.9742012821181008	exomes
global_rank	NA12878	VQSR	True	764	94.0	-3.301	-3.019	4	2	1	1	38375	37386	97	988	242	0.9974121601792812	0.9742534007400845	exomes
global_rank	NA12878	VQSR	True	768	95.0	-4.084	-3.466	7	3	3	1	38382	37389	100	985	239	0.9973325508815919	0.9743315786730599	exomes
global_rank	NA12878	VQSR	True	772	96.0	-5.266	-4.144	13	7	5	1	38395	37396	105	978	234	0.9972000746646756	0.9745139938500026	exomes
global_rank	NA12878	VQSR	True	776	97.0	-7.685	-5.508	13	3	9	1	38408	37399	114	975	225	0.9969610535014528	0.9745921717829781	exomes
global_rank	NA12878	VQSR	True	780	98.0	-19.3	-9.006	21	2	19	0	38429	37401	133	973	206	0.9964565460649012	0.9746442904049617	exomes
global_rank	NA12878	VQSR	True	784	99.0	-801.1	-21.48	266	54	206	6	38695	37455	339	919	0	0.9910303222733767	0.9760514931985198	exomes
global_rank	NA12878	VQSR	True	788	-1.0	-1.0	-1.0	18	0	0	18	38713	37455	339	919	0	0.9910303222733767	0.9760514931985198	exomes
global_rank	syndip	RF	False	2	0.0	0.9096124689823871	0.9175569526679231	5	4	0	1	5	4	0	1538	225	1.0	0.0025940337224383916	exomes
global_rank	syndip	RF	False	9	2.0	0.8995855042968076	0.9008421573761597	7	7	0	0	12	11	0	1531	225	1.0	0.007133592736705577	exomes
global_rank	syndip	RF	False	13	3.0	0.8958924303128506	0.8982432021197141	7	5	0	2	19	16	0	1526	225	1.0	0.010376134889753566	exomes
global_rank	syndip	RF	False	17	4.0	0.8929273977381224	0.8950688975965126	8	8	0	0	27	24	0	1518	225	1.0	0.01556420233463035	exomes
global_rank	syndip	RF	False	21	5.0	0.8885008003015598	0.8914285440377869	4	1	0	3	31	25	0	1517	225	1.0	0.01621271076523995	exomes
global_rank	syndip	RF	False	25	6.0	0.8809881754540161	0.8855797645515834	10	8	1	1	41	33	1	1509	224	0.9705882352941176	0.021400778210116732	exomes
global_rank	syndip	RF	False	29	7.0	0.8727033114913569	0.8798749074942666	13	8	1	4	54	41	2	1501	223	0.9534883720930233	0.026588845654993514	exomes
global_rank	syndip	RF	False	33	8.0	0.8617065858034015	0.871025755784927	11	6	3	2	65	47	5	1495	220	0.9038461538461539	0.0304798962386511	exomes
global_rank	syndip	RF	False	37	9.0	0.8570401244937731	0.861632432118312	6	4	0	2	71	51	5	1491	220	0.9107142857142857	0.033073929961089495	exomes
global_rank	syndip	RF	False	41	10.0	0.8546597000798352	0.8565693820209032	4	4	0	0	75	55	5	1487	220	0.9166666666666666	0.035667963683527884	exomes
global_rank	syndip	RF	False	45	11.0	0.8513364129733192	0.8540566133079	19	18	0	1	94	73	5	1469	220	0.9358974358974359	0.04734111543450065	exomes
global_rank	syndip	RF	False	49	12.0	0.8497001603637189	0.8513253083921826	10	9	0	1	104	82	5	1460	220	0.9425287356321839	0.05317769130998703	exomes
global_rank	syndip	RF	False	53	13.0	0.8468348153688882	0.8495025503092004	10	8	1	1	114	90	6	1452	219	0.9375	0.058365758754863814	exomes
global_rank	syndip	RF	False	57	14.0	0.8435149311051491	0.8466098749467548	13	9	1	3	127	99	7	1443	218	0.9339622641509434	0.06420233463035019	exomes
global_rank	syndip	RF	False	61	15.0	0.840303728911156	0.8434502422856223	47	42	0	5	174	141	7	1401	218	0.9527027027027027	0.0914396887159533	exomes
global_rank	syndip	RF	False	65	16.0	0.8377281796592512	0.8402741111269402	12	10	1	1	186	151	8	1391	217	0.949685534591195	0.09792477302204929	exomes
global_rank	syndip	RF	False	69	17.0	0.8348547085007225	0.8369129664119979	7	5	0	2	193	156	8	1386	217	0.9512195121951219	0.10116731517509728	exomes
global_rank	syndip	RF	False	73	18.0	0.8322025731503658	0.8340176815534228	22	20	0	2	215	176	8	1366	217	0.9565217391304348	0.11413748378728923	exomes
global_rank	syndip	RF	False	77	19.0	0.8301545662858816	0.8320348185511529	53	49	0	4	268	225	8	1317	217	0.9656652360515021	0.14591439688715954	exomes
global_rank	syndip	RF	False	81	20.0	0.8265104522215712	0.829579948741034	22	19	0	3	290	244	8	1298	217	0.9682539682539683	0.1582360570687419	exomes
global_rank	syndip	RF	False	85	21.0	0.8235757420789723	0.8263188291024224	13	11	0	2	303	255	8	1287	217	0.9695817490494296	0.16536964980544747	exomes
global_rank	syndip	RF	False	89	22.0	0.8203929935982239	0.8234717125501652	46	46	0	0	349	301	8	1241	217	0.9741100323624595	0.19520103761348898	exomes
global_rank	syndip	RF	False	93	23.0	0.8171760617548831	0.8202807622796571	22	16	0	6	371	317	8	1225	217	0.9753846153846154	0.20557717250324253	exomes
global_rank	syndip	RF	False	97	24.0	0.8138199067623153	0.817040142328362	24	17	0	7	395	334	8	1208	217	0.9766081871345029	0.21660181582360571	exomes
global_rank	syndip	RF	False	101	25.0	0.8115281902871019	0.8135897032732219	24	19	5	0	419	353	13	1189	212	0.9644808743169399	0.22892347600518806	exomes
global_rank	syndip	RF	False	105	26.0	0.8085641479256266	0.8110483976187132	28	26	0	2	447	379	13	1163	212	0.9668367346938775	0.2457846952010376	exomes
global_rank	syndip	RF	False	109	27.0	0.8060627543991067	0.8085526222706119	8	6	0	2	455	385	13	1157	212	0.9673366834170855	0.2496757457846952	exomes
global_rank	syndip	RF	False	113	28.0	0.8027303487883691	0.8058583259837702	39	38	0	1	494	423	13	1119	212	0.9701834862385321	0.27431906614785995	exomes
global_rank	syndip	RF	False	117	29.0	0.7991028692001971	0.8025903551001334	109	106	1	2	603	529	14	1013	211	0.9742173112338858	0.3430609597924773	exomes
global_rank	syndip	RF	False	121	30.0	0.7951526051974724	0.7988122987579901	42	37	1	4	645	566	15	976	210	0.9741824440619621	0.3670557717250324	exomes
global_rank	syndip	RF	False	125	31.0	0.7908063571016517	0.7950697337818556	78	75	1	2	723	641	16	901	209	0.9756468797564688	0.4156939040207523	exomes
global_rank	syndip	RF	False	129	32.0	0.7877279022861307	0.7907763837544562	55	51	0	4	778	692	16	850	209	0.9774011299435028	0.4487678339818418	exomes
global_rank	syndip	RF	False	133	33.0	0.7842250986619457	0.7873568237727318	53	46	1	6	831	738	17	804	208	0.9774834437086093	0.4785992217898833	exomes
global_rank	syndip	RF	False	137	34.0	0.7810344537791535	0.7841638089101227	29	25	0	4	860	763	17	779	208	0.9782051282051282	0.49481193255512324	exomes
global_rank	syndip	RF	False	141	35.0	0.7773681185250552	0.7810265273030085	22	15	2	5	882	778	19	764	206	0.9761606022584692	0.5045395590142672	exomes
global_rank	syndip	RF	False	145	36.0	0.773843404083442	0.7773490703076131	11	9	0	2	893	787	19	755	206	0.9764267990074442	0.5103761348897535	exomes
global_rank	syndip	RF	False	149	37.0	0.7704236113304609	0.7728535004621402	11	8	1	2	904	795	20	747	205	0.9754601226993865	0.5155642023346303	exomes
global_rank	syndip	RF	False	153	38.0	0.7664490803399326	0.7691592696475159	18	12	0	6	922	807	20	735	205	0.9758162031438936	0.5233463035019456	exomes
global_rank	syndip	RF	False	157	39.0	0.7635888539111007	0.7659388247849004	4	4	0	0	926	811	20	731	205	0.9759326113116726	0.5259403372243839	exomes
global_rank	syndip	RF	False	161	40.0	0.7601177304695007	0.7625495655623186	15	13	1	1	941	824	21	718	204	0.9751479289940829	0.5343709468223087	exomes
global_rank	syndip	RF	False	165	41.0	0.7561694522787087	0.7596899972702947	16	13	2	1	957	837	23	705	202	0.9732558139534884	0.5428015564202334	exomes
global_rank	syndip	RF	False	169	42.0	0.7520133923662083	0.7555555710137903	20	15	0	5	977	852	23	690	202	0.9737142857142858	0.5525291828793775	exomes
global_rank	syndip	RF	False	173	43.0	0.7487764991245471	0.7518181564414054	22	19	0	3	999	871	23	671	202	0.9742729306487695	0.5648508430609598	exomes
global_rank	syndip	RF	False	177	44.0	0.7443548237075697	0.7480314805851218	24	19	0	5	1023	890	23	652	202	0.9748083242059146	0.5771725032425421	exomes
global_rank	syndip	RF	False	181	45.0	0.7402870447337777	0.7439541154597392	14	12	1	1	1037	902	24	640	201	0.9740820734341252	0.5849546044098574	exomes
global_rank	syndip	RF	False	185	46.0	0.7358180958197473	0.7396281643370922	6	5	0	1	1043	907	24	635	201	0.9742212674543501	0.5881971465629053	exomes
global_rank	syndip	RF	False	189	47.0	0.7313804567381196	0.734152118767405	9	8	0	1	1052	915	24	627	201	0.9744408945686901	0.5933852140077821	exomes
global_rank	syndip	RF	False	193	48.0	0.726875163483519	0.7296267543192682	6	4	0	2	1058	919	24	623	201	0.9745493107104984	0.5959792477302205	exomes
global_rank	syndip	RF	False	197	49.0	0.7235084938433584	0.7261868590591843	3	1	0	2	1061	920	24	622	201	0.9745762711864406	0.5966277561608301	exomes
global_rank	syndip	RF	False	201	50.0	0.7158433401025012	0.7198164521030992	4	4	0	0	1065	924	24	618	201	0.9746835443037974	0.5992217898832685	exomes
global_rank	syndip	RF	False	205	51.0	0.710266764658852	0.7148022901721278	10	8	0	2	1075	932	24	610	201	0.9748953974895398	0.6044098573281452	exomes
global_rank	syndip	RF	False	209	52.0	0.7046049036158564	0.7096906888852604	10	6	0	4	1085	938	24	604	201	0.975051975051975	0.6083009079118028	exomes
global_rank	syndip	RF	False	213	53.0	0.6989714425821683	0.7035459197364852	13	9	0	4	1098	947	24	595	201	0.9752832131822863	0.6141374837872893	exomes
global_rank	syndip	RF	False	217	54.0	0.6929350134775792	0.6981109467691695	11	9	0	2	1109	956	24	586	201	0.9755102040816327	0.6199740596627756	exomes
global_rank	syndip	RF	False	221	55.0	0.6878359456417547	0.6911401890959106	13	12	0	1	1122	968	24	574	201	0.9758064516129032	0.6277561608300908	exomes
global_rank	syndip	RF	False	225	56.0	0.6784833023420074	0.6845963643428322	16	10	4	2	1138	978	28	564	197	0.9721669980119284	0.6342412451361867	exomes
global_rank	syndip	RF	False	229	57.0	0.6703135489633336	0.6777816257403226	8	5	1	2	1146	983	29	559	196	0.9713438735177866	0.6374837872892347	exomes
global_rank	syndip	RF	False	233	58.0	0.6634327100148015	0.6696742139831977	5	3	0	2	1151	986	29	556	196	0.9714285714285714	0.6394293125810635	exomes
global_rank	syndip	RF	False	237	59.0	0.6547347144646654	0.6610226567663168	11	6	3	2	1162	992	32	550	193	0.96875	0.6433203631647212	exomes
global_rank	syndip	RF	False	241	60.0	0.6395914374720179	0.6510768439403308	17	9	3	5	1179	1001	35	541	190	0.9662162162162162	0.6491569390402075	exomes
global_rank	syndip	RF	False	245	61.0	0.6322769388004361	0.6385708204139733	9	1	4	4	1188	1002	39	540	186	0.962536023054755	0.6498054474708171	exomes
global_rank	syndip	RF	False	249	62.0	0.6100646397419788	0.6237438935258007	7	0	2	5	1195	1002	41	540	184	0.9606903163950143	0.6498054474708171	exomes
global_rank	syndip	RF	False	253	63.0	0.5887829028960883	0.6002818733348751	2	1	1	0	1197	1003	42	539	183	0.9598086124401913	0.6504539559014267	exomes
global_rank	syndip	RF	False	257	64.0	0.5587410361407169	0.5735500755865441	6	3	1	2	1203	1006	43	536	182	0.9590085795996187	0.6523994811932555	exomes
global_rank	syndip	RF	False	261	65.0	0.5207284812412483	0.5475565127070783	9	5	2	2	1212	1011	45	531	180	0.9573863636363636	0.6556420233463035	exomes
global_rank	syndip	RF	False	265	66.0	0.4959761744052165	0.5196393360812203	9	8	0	1	1221	1019	45	523	180	0.9577067669172933	0.6608300907911803	exomes
global_rank	syndip	RF	False	269	67.0	0.4726718992013114	0.4911735291568212	10	7	1	2	1231	1026	46	516	179	0.957089552238806	0.6653696498054474	exomes
global_rank	syndip	RF	False	273	68.0	0.4603304227499616	0.4686248868627349	8	2	2	4	1239	1028	48	514	177	0.9553903345724907	0.6666666666666666	exomes
global_rank	syndip	RF	False	277	69.0	0.43285857636099156	0.4507054262561271	7	5	0	2	1246	1033	48	509	177	0.9555966697502313	0.6699092088197146	exomes
global_rank	syndip	RF	False	281	70.0	0.4105407085277983	0.4113021866552137	2	1	0	1	1248	1034	48	508	177	0.955637707948244	0.6705577172503242	exomes
global_rank	syndip	RF	False	285	71.0	0.39356279163866303	0.40340329598130303	4	0	2	2	1252	1034	50	508	175	0.9538745387453874	0.6705577172503242	exomes
global_rank	syndip	RF	False	289	72.0	0.3710399386776013	0.38860697808432143	10	6	2	2	1262	1040	52	502	173	0.9523809523809523	0.6744487678339819	exomes
global_rank	syndip	RF	False	293	73.0	0.35631426751680806	0.365728870848436	5	3	1	1	1267	1043	53	499	172	0.9516423357664233	0.6763942931258107	exomes
global_rank	syndip	RF	False	297	74.0	0.3217030839180006	0.33891918014842093	8	6	0	2	1275	1049	53	493	172	0.9519056261343013	0.6802853437094682	exomes
global_rank	syndip	RF	False	301	75.0	0.3043649580934755	0.31815841041135356	13	2	5	6	1288	1051	58	491	167	0.9477006311992786	0.6815823605706874	exomes
global_rank	syndip	RF	False	305	76.0	0.2749237805782285	0.30109916391111075	10	2	2	6	1298	1053	60	489	165	0.9460916442048517	0.6828793774319066	exomes
global_rank	syndip	RF	False	309	77.0	0.2503385519654242	0.27243626502147417	17	1	10	6	1315	1054	70	488	155	0.9377224199288257	0.6835278858625162	exomes
global_rank	syndip	RF	False	313	78.0	0.23375112107219354	0.24528037894095078	6	0	6	0	1321	1054	76	488	149	0.9327433628318584	0.6835278858625162	exomes
global_rank	syndip	RF	False	317	79.0	0.20635744902171774	0.22590395991485251	7	3	4	0	1328	1057	80	485	145	0.9296394019349165	0.685473411154345	exomes
global_rank	syndip	RF	False	321	80.0	0.1829018047101044	0.20501903628956733	9	1	7	1	1337	1058	87	484	138	0.9240174672489083	0.6861219195849546	exomes
global_rank	syndip	RF	False	325	81.0	0.16423424776640294	0.18200921330678016	15	0	14	1	1352	1058	101	484	124	0.9128559102674719	0.6861219195849546	exomes
global_rank	syndip	RF	False	328	82.0	0.15481334654362136	0.1621355514640851	23	1	22	0	1375	1059	123	483	102	0.8959390862944162	0.6867704280155642	exomes
global_rank	syndip	RF	False	332	83.0	0.1444403719937205	0.1543256877216575	17	0	17	0	1392	1059	140	483	85	0.8832360300250208	0.6867704280155642	exomes
global_rank	syndip	RF	False	335	84.0	0.1308602768867519	0.14161954608078306	18	0	14	4	1410	1059	154	483	71	0.8730420445177246	0.6867704280155642	exomes
global_rank	syndip	RF	False	339	85.0	0.12100373211259773	0.12815279152452994	13	0	12	1	1423	1059	166	483	59	0.8644897959183674	0.6867704280155642	exomes
global_rank	syndip	RF	False	343	86.0	0.11144072141014869	0.12011901650600444	7	0	7	0	1430	1059	173	483	52	0.859577922077922	0.6867704280155642	exomes
global_rank	syndip	RF	False	346	87.0	0.1054357475673679	0.10980064520213692	5	0	4	1	1435	1059	177	483	48	0.8567961165048543	0.6867704280155642	exomes
global_rank	syndip	RF	False	350	88.0	0.09952273357209197	0.10467647697049118	6	0	6	0	1441	1059	183	483	42	0.8526570048309179	0.6867704280155642	exomes
global_rank	syndip	RF	False	354	89.0	0.08783037011571729	0.09771213885969829	8	0	7	1	1449	1059	190	483	35	0.8478783026421137	0.6867704280155642	exomes
global_rank	syndip	RF	False	357	90.0	0.0803020685655699	0.08643576474354364	4	0	3	1	1453	1059	193	483	32	0.8458466453674122	0.6867704280155642	exomes
global_rank	syndip	RF	False	361	91.0	0.06956213528168712	0.07691143621228926	11	0	10	1	1464	1059	203	483	22	0.8391442155309033	0.6867704280155642	exomes
global_rank	syndip	RF	False	365	92.0	0.06060786928092986	0.06698331648484938	4	1	3	0	1468	1060	206	482	19	0.8372827804107424	0.6874189364461738	exomes
global_rank	syndip	RF	False	368	93.0	0.04879504125963911	0.05579071742769778	7	0	7	0	1475	1060	213	482	12	0.8326787117046347	0.6874189364461738	exomes
global_rank	syndip	RF	False	372	94.0	0.04208906866762452	0.04659236234180387	4	0	4	0	1479	1060	217	482	8	0.8300704776820673	0.6874189364461738	exomes
global_rank	syndip	RF	False	375	95.0	0.03693285062074897	0.03916126659216688	4	0	4	0	1483	1060	221	482	4	0.8274785323965652	0.6874189364461738	exomes
global_rank	syndip	RF	False	378	96.0	0.033772274857398435	0.035805652498631976	2	0	1	1	1485	1060	222	482	3	0.8268330733229329	0.6874189364461738	exomes
global_rank	syndip	RF	False	381	97.0	0.03011292313894712	0.03211738185374602	2	0	2	0	1487	1060	224	482	1	0.8255451713395638	0.6874189364461738	exomes
global_rank	syndip	RF	False	385	98.0	0.024927281774009356	0.024927281774009356	1	0	1	0	1488	1060	225	482	0	0.8249027237354085	0.6874189364461738	exomes
global_rank	syndip	RF	False	391	-1.0	-1.0	-1.0	279	0	0	279	1767	1060	225	482	0	0.8249027237354085	0.6874189364461738	exomes
global_rank	syndip	RF	True	395	0.0	0.940326909875765	0.940326909875765	12870	12721	2	147	12870	12721	2	27792	536	0.9998428043700385	0.31399797595833434	exomes
global_rank	syndip	RF	True	399	1.0	0.9395401180862586	0.940326909875765	1250	1216	0	34	14120	13937	2	26576	536	0.9998565176841955	0.3440130328536519	exomes
global_rank	syndip	RF	True	403	2.0	0.9393634327490663	0.9395401180862586	530	525	0	5	14650	14462	2	26051	536	0.9998617256637168	0.3569718362007257	exomes
global_rank	syndip	RF	True	407	3.0	0.9388581575192725	0.9393634327490663	3823	3791	3	29	18473	18253	5	22260	533	0.9997261474422171	0.45054673808407175	exomes
global_rank	syndip	RF	True	411	4.0	0.9374117055303784	0.9388581575192725	121	119	0	2	18594	18372	5	22141	533	0.9997279207705284	0.45348406684274184	exomes
global_rank	syndip	RF	True	415	5.0	0.9359289229606387	0.9370704844796455	254	248	0	6	18848	18620	5	21893	533	0.9997315436241611	0.45960555870955	exomes
global_rank	syndip	RF	True	419	6.0	0.934331965471451	0.9359289229606387	160	147	0	13	19008	18767	5	21746	533	0.9997336458555295	0.46323402364673066	exomes
global_rank	syndip	RF	True	423	7.0	0.9321719802867373	0.9341073652613097	158	149	0	9	19166	18916	5	21597	533	0.9997357433539453	0.4669118554538049	exomes
global_rank	syndip	RF	True	427	8.0	0.9313031796444111	0.9318764515232497	36	33	0	3	19202	18949	5	21564	533	0.9997362034399071	0.4677264088070496	exomes
global_rank	syndip	RF	True	431	9.0	0.9297084723823957	0.9311872810237413	10	8	1	1	19212	18957	6	21556	532	0.9996835943679797	0.4679238762866241	exomes
global_rank	syndip	RF	True	435	10.0	0.9282333230605512	0.9294749021771662	63	58	0	5	19275	19015	6	21498	532	0.999684559171442	0.4693555155135389	exomes
global_rank	syndip	RF	True	439	11.0	0.9263324182700265	0.9277118921195303	194	192	0	2	19469	19207	6	21306	532	0.9996877114453755	0.47409473502332583	exomes
global_rank	syndip	RF	True	443	12.0	0.9246641508428851	0.9259226903450869	6519	6388	1	130	25988	25595	7	14918	531	0.9997265838606358	0.6317725174635302	exomes
global_rank	syndip	RF	True	447	13.0	0.923196740432898	0.9244888074521984	2677	2612	0	65	28665	28207	7	12306	531	0.9997518962217339	0.6962456495445907	exomes
global_rank	syndip	RF	True	451	14.0	0.9198824959264207	0.923168307343855	96	90	0	6	28761	28297	7	12216	531	0.9997526851328434	0.6984671586898032	exomes
global_rank	syndip	RF	True	455	15.0	0.9167717722468406	0.9189625549966615	1958	1901	1	56	30719	30198	8	10315	530	0.9997351519565649	0.7453903685236838	exomes
global_rank	syndip	RF	True	459	16.0	0.9113332661569825	0.9166262741316343	953	866	0	87	31672	31064	8	9449	530	0.9997425334706488	0.7667662231876188	exomes
global_rank	syndip	RF	True	463	17.0	0.9066475624259768	0.9113332661569825	644	492	0	152	32316	31556	8	8957	530	0.9997465466987707	0.7789104731814479	exomes
global_rank	syndip	RF	True	467	18.0	0.9025172758025951	0.9064970800449058	1453	1420	2	31	33769	32976	10	7537	528	0.9996968410840963	0.8139609508059141	exomes
global_rank	syndip	RF	True	471	19.0	0.8976470629601269	0.9024125083783043	908	853	1	54	34677	33829	11	6684	527	0.9996749408983452	0.8350159208155407	exomes
global_rank	syndip	RF	True	475	20.0	0.8860019207275962	0.8971935996235294	356	333	1	22	35033	34162	12	6351	526	0.9996488558553286	0.8432355046528275	exomes
global_rank	syndip	RF	True	479	21.0	0.8774533991216362	0.8860019207275962	526	485	1	40	35559	34647	13	5866	525	0.9996249278707444	0.855206970602029	exomes
global_rank	syndip	RF	True	483	22.0	0.8728822521677381	0.8773073783117912	140	132	0	8	35699	34779	13	5734	525	0.999626350885261	0.8584651840150075	exomes
global_rank	syndip	RF	True	487	23.0	0.8708496590019882	0.8727814567738787	208	197	2	9	35907	34976	15	5537	523	0.9995713183390015	0.8633278206995285	exomes
global_rank	syndip	RF	True	491	24.0	0.8686603267061266	0.8707228452553336	73	65	1	7	35980	35041	16	5472	522	0.9995436004221696	0.864932243971071	exomes
global_rank	syndip	RF	True	495	25.0	0.8670129632172343	0.8685675120962616	190	182	1	7	36170	35223	17	5290	521	0.9995175936435868	0.86942462913139	exomes
global_rank	syndip	RF	True	499	26.0	0.8657201323947327	0.866921097063909	237	231	0	6	36407	35454	17	5059	521	0.9995207352485128	0.8751265026041024	exomes
global_rank	syndip	RF	True	503	27.0	0.8640552574099686	0.8656949435934119	42	40	0	2	36449	35494	17	5019	521	0.999521275097857	0.8761138400019747	exomes
global_rank	syndip	RF	True	507	28.0	0.8625355220735323	0.863932450356634	329	312	0	17	36778	35806	17	4707	521	0.9995254445467996	0.8838150717053785	exomes
global_rank	syndip	RF	True	511	29.0	0.8603425301796809	0.8624932644117593	88	86	0	2	36866	35892	17	4621	521	0.9995265810799521	0.8859378471108039	exomes
global_rank	syndip	RF	True	515	30.0	0.8580852730428525	0.8602960601356202	102	97	0	5	36968	35989	17	4524	521	0.9995278564683664	0.8883321403006442	exomes
global_rank	syndip	RF	True	519	31.0	0.8553837790888831	0.8580528390365781	388	368	0	20	37356	36357	17	4156	521	0.9995326331995381	0.8974156443610692	exomes
global_rank	syndip	RF	True	523	32.0	0.8533985856851773	0.8552895174492354	71	60	0	11	37427	36417	17	4096	521	0.9995334028654553	0.8988966504578777	exomes
global_rank	syndip	RF	True	527	33.0	0.851345467577701	0.8532200646677385	87	82	0	5	37514	36499	17	4014	521	0.999534450651769	0.9009206921235159	exomes
global_rank	syndip	RF	True	531	34.0	0.8490444791895527	0.8513008931493348	50	48	0	2	37564	36547	17	3966	521	0.9995350618094301	0.9021054970009627	exomes
global_rank	syndip	RF	True	535	35.0	0.8469119425119678	0.8489239621422163	62	50	0	12	37626	36597	17	3916	521	0.9995356967280276	0.903339668748303	exomes
global_rank	syndip	RF	True	539	36.0	0.8434185236999582	0.8468490680338431	110	99	0	11	37736	36696	17	3817	521	0.9995369487647427	0.9057833288080369	exomes
global_rank	syndip	RF	True	543	37.0	0.838695725683833	0.8431402600111282	227	216	1	10	37963	36912	18	3601	520	0.9995125913891145	0.9111149507565472	exomes
global_rank	syndip	RF	True	547	38.0	0.8350816904822355	0.8384679818970437	196	182	1	13	38159	37094	19	3419	519	0.9994880500094306	0.9156073359168662	exomes
global_rank	syndip	RF	True	551	39.0	0.8316740877879453	0.8347803358588871	99	87	0	12	38258	37181	19	3332	519	0.999489247311828	0.9177547947572384	exomes
global_rank	syndip	RF	True	555	40.0	0.8286965117446657	0.8314544060514787	80	78	0	2	38338	37259	19	3254	519	0.9994903160040775	0.9196801026830894	exomes
global_rank	syndip	RF	True	559	41.0	0.8258689592447711	0.8285810355201941	72	69	0	3	38410	37328	19	3185	519	0.9994912576646049	0.921383259694419	exomes
global_rank	syndip	RF	True	563	42.0	0.8224956961219319	0.8256565399404522	160	123	0	37	38570	37451	19	3062	519	0.9994929276754737	0.9244193221928764	exomes
global_rank	syndip	RF	True	567	43.0	0.8194229965369867	0.8223544903524868	77	70	1	6	38647	37521	20	2992	518	0.9994672491409392	0.9261471626391529	exomes
global_rank	syndip	RF	True	571	44.0	0.8158826567640343	0.8192448348567465	118	104	0	14	38765	37625	20	2888	518	0.9994687209456767	0.9287142398736208	exomes
global_rank	syndip	RF	True	575	45.0	0.8122801323239254	0.8158411355382083	66	54	0	12	38831	37679	20	2834	518	0.9994694819491233	0.9300471453607484	exomes
global_rank	syndip	RF	True	579	46.0	0.8080423827178684	0.8121065436912716	116	72	0	44	38947	37751	20	2762	518	0.999470493235551	0.9318243526769185	exomes
global_rank	syndip	RF	True	583	47.0	0.8043600147117702	0.8080390869289631	127	116	0	11	39074	37867	20	2646	518	0.9994721144455881	0.9346876311307482	exomes
global_rank	syndip	RF	True	587	48.0	0.7999398713711461	0.8038891937199403	60	49	0	11	39134	37916	20	2597	518	0.9994727962884858	0.9358971194431417	exomes
global_rank	syndip	RF	True	591	49.0	0.7956589142966305	0.7998381472898382	58	54	0	4	39192	37970	20	2543	518	0.9994735456699131	0.9372300249302693	exomes
global_rank	syndip	RF	True	595	50.0	0.7910632060043697	0.7956116311464976	49	45	0	4	39241	38015	20	2498	518	0.9994741685289864	0.9383407795028756	exomes
global_rank	syndip	RF	True	599	51.0	0.7864170300171239	0.7904150436747285	39	35	0	4	39280	38050	20	2463	518	0.9994746519569214	0.9392046997260138	exomes
global_rank	syndip	RF	True	602	52.0	0.7822828860978904	0.7862878122418462	37	28	0	9	39317	38078	20	2435	518	0.9994750380597407	0.9398958359045245	exomes
global_rank	syndip	RF	True	606	53.0	0.7783240420913701	0.7818908769864182	37	28	1	8	39354	38106	21	2407	517	0.9994492092218114	0.9405869720830351	exomes
global_rank	syndip	RF	True	609	54.0	0.7735785135388087	0.7780560788340282	31	29	0	2	39385	38135	21	2378	517	0.9994496278435895	0.9413027916964924	exomes
global_rank	syndip	RF	True	613	55.0	0.7690810602586554	0.7731998016888689	35	29	0	6	39420	38164	21	2349	517	0.9994500458295142	0.9420186113099499	exomes
global_rank	syndip	RF	True	616	56.0	0.7638423837443352	0.7687303995902823	30	24	1	5	39450	38188	22	2325	516	0.9994242344935881	0.9426110137486733	exomes
global_rank	syndip	RF	True	620	57.0	0.7584535356096428	0.7635395276578131	37	31	1	5	39487	38219	23	2294	515	0.9993985670205533	0.9433762002320243	exomes
global_rank	syndip	RF	True	624	58.0	0.7522170178495807	0.7579227227487361	35	29	1	5	39522	38248	24	2265	514	0.9993729096989966	0.9440920198454817	exomes
global_rank	syndip	RF	True	628	59.0	0.7445250061281479	0.7515530822659072	25	17	0	8	39547	38265	24	2248	514	0.9993731881219149	0.9445116382395774	exomes
global_rank	syndip	RF	True	632	60.0	0.7367843454490061	0.7441062412585776	21	16	0	5	39568	38281	24	2232	514	0.999373449941261	0.9449065731987263	exomes
global_rank	syndip	RF	True	636	61.0	0.7294730933569218	0.7364530044431119	36	30	1	5	39604	38311	25	2202	513	0.9993478714524207	0.9456470762471305	exomes
global_rank	syndip	RF	True	640	62.0	0.7212615426409593	0.7287320109717481	17	9	0	8	39621	38320	25	2193	513	0.9993480245142783	0.9458692271616518	exomes
global_rank	syndip	RF	True	643	63.0	0.7109656436926207	0.7208441199745598	16	13	1	2	39637	38333	26	2180	512	0.9993221929664485	0.9461901118159604	exomes
global_rank	syndip	RF	True	647	64.0	0.701588630071772	0.7097316569486957	19	13	0	6	39656	38346	26	2167	512	0.9993224225998124	0.9465109964702688	exomes
global_rank	syndip	RF	True	651	65.0	0.6908645539907915	0.7009696312384883	16	14	0	2	39672	38360	26	2153	512	0.9993226697233366	0.946856564559524	exomes
global_rank	syndip	RF	True	655	66.0	0.6776582663273053	0.6899700599045213	15	13	1	1	39687	38373	27	2140	511	0.999296875	0.9471774492138326	exomes
global_rank	syndip	RF	True	659	67.0	0.6652877254395152	0.6766411078023006	61	48	1	12	39748	38421	28	2092	510	0.9992717625946058	0.9483622540912794	exomes
global_rank	syndip	RF	True	663	68.0	0.6487866368723464	0.6643519142553738	25	17	2	6	39773	38438	30	2075	508	0.999220131017989	0.948781872485375	exomes
global_rank	syndip	RF	True	667	69.0	0.6230773665714144	0.6480481557935575	31	16	4	11	39804	38454	34	2059	504	0.9991166077738516	0.9491768074445239	exomes
global_rank	syndip	RF	True	671	70.0	0.5896658093856333	0.6209076819170726	41	25	5	11	39845	38479	39	2034	499	0.9989874863700088	0.9497938933181942	exomes
global_rank	syndip	RF	True	675	71.0	0.5678807083354166	0.5879501332038325	57	51	2	4	39902	38530	41	1983	497	0.9989370252262062	0.9510527485004814	exomes
global_rank	syndip	RF	True	679	72.0	0.5478213867491496	0.5672878186312269	46	26	3	17	39948	38556	44	1957	494	0.998860103626943	0.9516945178090983	exomes
global_rank	syndip	RF	True	683	73.0	0.5253816630851292	0.547517413586684	56	32	1	23	40004	38588	45	1925	493	0.9988351927108948	0.9524843877273962	exomes
global_rank	syndip	RF	True	687	74.0	0.5039690664115545	0.52450181608565	47	31	1	15	40051	38619	46	1894	492	0.9988102935471357	0.9532495742107472	exomes
global_rank	syndip	RF	True	691	75.0	0.48616453729685905	0.5033094728921502	52	29	4	19	40103	38648	50	1865	488	0.9987079435629749	0.9539653938242045	exomes
global_rank	syndip	RF	True	694	76.0	0.4662814443743202	0.4850783247057897	41	23	4	14	40144	38671	54	1842	484	0.9986055519690122	0.9545331128279811	exomes
global_rank	syndip	RF	True	698	77.0	0.4440228092566856	0.4656579856871482	42	19	7	16	40186	38690	61	1823	477	0.9984258470749142	0.9550020980919705	exomes
global_rank	syndip	RF	True	702	78.0	0.41662373727435204	0.4430691034496951	32	12	1	19	40218	38702	62	1811	476	0.9984005778557424	0.9552982993113321	exomes
global_rank	syndip	RF	True	705	79.0	0.3909223182046334	0.41532478652759636	24	11	1	12	40242	38713	63	1800	475	0.9983752836806272	0.9555698170957471	exomes
global_rank	syndip	RF	True	709	80.0	0.3597856976868599	0.38998662698332603	43	32	1	10	40285	38745	64	1768	474	0.9983508979875803	0.9563596870140448	exomes
global_rank	syndip	RF	True	713	81.0	0.3182021717690468	0.35858662280322107	45	25	14	6	40330	38770	78	1743	460	0.9979921746293245	0.9569767728877151	exomes
global_rank	syndip	RF	True	717	82.0	0.2822679906548884	0.3170219769188854	16	10	2	4	40346	38780	80	1733	458	0.997941327843541	0.9572236072371831	exomes
global_rank	syndip	RF	True	721	83.0	0.2487913851777691	0.2787111218642738	27	9	11	7	40373	38789	91	1724	447	0.9976594650205761	0.9574457581517044	exomes
global_rank	syndip	RF	True	725	84.0	0.2194476885154588	0.24596271823342722	35	13	20	2	40408	38802	111	1711	427	0.9971474828463496	0.9577666428060129	exomes
global_rank	syndip	RF	True	729	85.0	0.18938284957508078	0.21587163780826554	50	15	30	5	40458	38817	141	1696	397	0.9963807176959802	0.958136894330215	exomes
global_rank	syndip	RF	True	733	86.0	0.15890958435962257	0.18657069205069288	28	4	21	3	40486	38821	162	1692	376	0.995844342405664	0.9582356280700022	exomes
global_rank	syndip	RF	True	737	87.0	0.13562069791496312	0.15802654055870066	35	8	24	3	40521	38829	186	1684	352	0.9952326028450595	0.9584330955495767	exomes
global_rank	syndip	RF	True	741	88.0	0.1141869376248092	0.13517735156313482	48	7	33	8	40569	38836	219	1677	319	0.994392523364486	0.9586058795942043	exomes
global_rank	syndip	RF	True	745	89.0	0.09691036482258482	0.11393169597535852	41	5	31	5	40610	38841	250	1672	288	0.9936046660356603	0.9587292967689384	exomes
global_rank	syndip	RF	True	749	90.0	0.08158020915298193	0.09641491739415105	33	4	29	0	40643	38845	279	1668	259	0.9928688273182701	0.9588280305087256	exomes
global_rank	syndip	RF	True	753	91.0	0.06302731780039425	0.0810868276259718	53	10	43	0	40696	38855	322	1658	216	0.9917808918498099	0.9590748648581937	exomes
global_rank	syndip	RF	True	757	92.0	0.04959716521800598	0.06189041931588165	49	3	45	1	40745	38858	367	1655	171	0.9906437221159975	0.9591489151630341	exomes
global_rank	syndip	RF	True	761	93.0	0.042054289286614754	0.04843905293308288	28	3	25	0	40773	38861	392	1652	146	0.9900135021527017	0.9592229654678746	exomes
global_rank	syndip	RF	True	765	94.0	0.03598118518419334	0.041461552140602966	47	6	40	1	40820	38867	432	1646	106	0.9890073538766889	0.9593710660775554	exomes
global_rank	syndip	RF	True	769	95.0	0.030724252780676767	0.03564342907010125	40	7	33	0	40860	38874	465	1639	73	0.9881796690307328	0.959543850122183	exomes
global_rank	syndip	RF	True	773	96.0	0.025295895035629904	0.03040206286734072	28	7	21	0	40888	38881	486	1632	52	0.9876546345924251	0.9597166341668106	exomes
global_rank	syndip	RF	True	777	97.0	0.020932022797544535	0.025090959054039	30	5	25	0	40918	38886	511	1627	27	0.9870294692489275	0.9598400513415447	exomes
global_rank	syndip	RF	True	781	98.0	0.017493143015698966	0.02009118828893971	11	2	8	1	40929	38888	519	1625	19	0.9868297510594565	0.9598894182114383	exomes
global_rank	syndip	RF	True	785	99.0	0.010546956365827044	0.016766758554093004	24	5	19	0	40953	38893	538	1620	0	0.9863559128604398	0.9600128353861723	exomes
global_rank	syndip	RF	True	789	-1.0	-1.0	-1.0	98	0	0	98	41051	38893	538	1620	0	0.9863559128604398	0.9600128353861723	exomes
global_rank	syndip	VQSR	False	3	0.0	6.11	7.58	171	162	4	5	171	162	4	1380	221	0.9759036144578314	0.10505836575875487	exomes
global_rank	syndip	VQSR	False	6	1.0	5.9	6.09	34	27	3	4	205	189	7	1353	218	0.9642857142857143	0.122568093385214	exomes
global_rank	syndip	VQSR	False	10	2.0	5.73	5.89	38	35	1	2	243	224	8	1318	217	0.9655172413793104	0.14526588845654995	exomes
global_rank	syndip	VQSR	False	14	3.0	5.57	5.73	24	22	1	1	267	246	9	1296	216	0.9647058823529412	0.15953307392996108	exomes
global_rank	syndip	VQSR	False	18	4.0	5.39	5.56	35	31	0	4	302	277	9	1265	216	0.9685314685314685	0.17963683527885863	exomes
global_rank	syndip	VQSR	False	22	5.0	5.21	5.39	35	32	2	1	337	309	11	1233	214	0.965625	0.20038910505836577	exomes
global_rank	syndip	VQSR	False	26	6.0	4.99	5.19	30	27	2	1	367	336	13	1206	212	0.9627507163323782	0.2178988326848249	exomes
global_rank	syndip	VQSR	False	30	7.0	4.76	4.98	40	31	6	3	407	367	19	1175	206	0.9507772020725389	0.23800259403372243	exomes
global_rank	syndip	VQSR	False	34	8.0	4.54	4.73	24	18	4	2	431	385	23	1157	202	0.9436274509803921	0.2496757457846952	exomes
global_rank	syndip	VQSR	False	38	9.0	4.36	4.52	22	17	2	3	453	402	25	1140	200	0.9414519906323185	0.2607003891050584	exomes
global_rank	syndip	VQSR	False	42	10.0	4.19	4.35	37	31	5	1	490	433	30	1109	195	0.9352051835853131	0.2808041504539559	exomes
global_rank	syndip	VQSR	False	46	11.0	4.01	4.18	43	32	4	7	533	465	34	1077	191	0.9318637274549099	0.301556420233463	exomes
global_rank	syndip	VQSR	False	50	12.0	3.85	4.01	36	29	4	3	569	494	38	1048	187	0.9285714285714286	0.3203631647211414	exomes
global_rank	syndip	VQSR	False	54	13.0	3.67	3.84	36	29	2	5	605	523	40	1019	185	0.9289520426287744	0.33916990920881973	exomes
global_rank	syndip	VQSR	False	58	14.0	3.51	3.67	43	37	6	0	648	560	46	982	179	0.9240924092409241	0.3631647211413748	exomes
global_rank	syndip	VQSR	False	62	15.0	3.36	3.51	46	28	12	6	694	588	58	954	167	0.9102167182662538	0.38132295719844356	exomes
global_rank	syndip	VQSR	False	66	16.0	3.21	3.36	33	21	7	5	727	609	65	933	160	0.9035608308605341	0.3949416342412451	exomes
global_rank	syndip	VQSR	False	70	17.0	3.09	3.21	33	24	6	3	760	633	71	909	154	0.8991477272727273	0.41050583657587547	exomes
global_rank	syndip	VQSR	False	74	18.0	3.0	3.08	27	24	0	3	787	657	71	885	154	0.9024725274725275	0.4260700389105058	exomes
global_rank	syndip	VQSR	False	78	19.0	2.94	2.99	18	15	1	2	805	672	72	870	153	0.9032258064516129	0.4357976653696498	exomes
global_rank	syndip	VQSR	False	82	20.0	2.88	2.93	18	14	2	2	823	686	74	856	151	0.9026315789473685	0.44487678339818415	exomes
global_rank	syndip	VQSR	False	86	21.0	2.81	2.87	17	13	1	3	840	699	75	843	150	0.9031007751937985	0.45330739299610895	exomes
global_rank	syndip	VQSR	False	90	22.0	2.73	2.8	14	8	1	5	854	707	76	835	149	0.9029374201787995	0.4584954604409857	exomes
global_rank	syndip	VQSR	False	94	23.0	2.66	2.73	19	14	4	1	873	721	80	821	145	0.9001248439450686	0.4675745784695201	exomes
global_rank	syndip	VQSR	False	98	24.0	2.58	2.64	17	14	2	1	890	735	82	807	143	0.8996328029375765	0.4766536964980545	exomes
global_rank	syndip	VQSR	False	102	25.0	2.51	2.58	13	10	3	0	903	745	85	797	140	0.8975903614457831	0.48313878080415046	exomes
global_rank	syndip	VQSR	False	106	26.0	2.46	2.51	7	5	0	2	910	750	85	792	140	0.8982035928143712	0.48638132295719844	exomes
global_rank	syndip	VQSR	False	110	27.0	2.36	2.43	20	17	1	2	930	767	86	775	139	0.8991793669402111	0.4974059662775616	exomes
global_rank	syndip	VQSR	False	114	28.0	2.29	2.36	9	4	4	1	939	771	90	771	135	0.8954703832752613	0.5	exomes
global_rank	syndip	VQSR	False	118	29.0	2.23	2.28	13	9	3	1	952	780	93	762	132	0.8934707903780069	0.5058365758754864	exomes
global_rank	syndip	VQSR	False	122	30.0	2.17	2.22	18	9	2	7	970	789	95	753	130	0.8925339366515838	0.5116731517509727	exomes
global_rank	syndip	VQSR	False	126	31.0	2.11	2.16	13	8	2	3	983	797	97	745	128	0.8914988814317674	0.5168612191958496	exomes
global_rank	syndip	VQSR	False	130	32.0	2.05	2.1	11	9	0	2	994	806	97	736	128	0.8925802879291251	0.522697795071336	exomes
global_rank	syndip	VQSR	False	134	33.0	2.01	2.05	11	7	1	3	1005	813	98	729	127	0.8924259055982436	0.5272373540856031	exomes
global_rank	syndip	VQSR	False	138	34.0	1.94	1.99	11	4	1	6	1016	817	99	725	126	0.8919213973799127	0.5298313878080415	exomes
global_rank	syndip	VQSR	False	142	35.0	1.89	1.94	17	15	0	2	1033	832	99	710	126	0.8936627282491945	0.5395590142671854	exomes
global_rank	syndip	VQSR	False	146	36.0	1.83	1.88	10	8	0	2	1043	840	99	702	126	0.8945686900958466	0.5447470817120622	exomes
global_rank	syndip	VQSR	False	150	37.0	1.77	1.82	10	8	1	1	1053	848	100	694	125	0.8945147679324894	0.5499351491569391	exomes
global_rank	syndip	VQSR	False	154	38.0	1.72	1.77	17	14	1	2	1070	862	101	680	124	0.8951194184839044	0.5590142671854734	exomes
global_rank	syndip	VQSR	False	158	39.0	1.65	1.71	10	6	1	3	1080	868	102	674	123	0.8948453608247423	0.562905317769131	exomes
global_rank	syndip	VQSR	False	162	40.0	1.58	1.64	14	10	2	2	1094	878	104	664	121	0.8940936863543788	0.569390402075227	exomes
global_rank	syndip	VQSR	False	166	41.0	1.51	1.58	11	7	1	3	1105	885	105	657	120	0.8939393939393939	0.5739299610894941	exomes
global_rank	syndip	VQSR	False	170	42.0	1.45	1.51	6	4	1	1	1111	889	106	653	119	0.893467336683417	0.5765239948119325	exomes
global_rank	syndip	VQSR	False	174	43.0	1.38	1.44	9	7	0	2	1120	896	106	646	119	0.8942115768463074	0.5810635538261998	exomes
global_rank	syndip	VQSR	False	178	44.0	1.31	1.37	15	9	3	3	1135	905	109	637	116	0.8925049309664694	0.5869001297016861	exomes
global_rank	syndip	VQSR	False	182	45.0	1.24	1.3	8	7	1	0	1143	912	110	630	115	0.8923679060665362	0.5914396887159533	exomes
global_rank	syndip	VQSR	False	186	46.0	1.17	1.23	18	15	1	2	1161	927	111	615	114	0.8930635838150289	0.6011673151750972	exomes
global_rank	syndip	VQSR	False	190	47.0	1.12	1.17	12	8	3	1	1173	935	114	607	111	0.8913250714966635	0.606355382619974	exomes
global_rank	syndip	VQSR	False	194	48.0	1.08	1.12	11	3	4	4	1184	938	118	604	107	0.8882575757575758	0.6083009079118028	exomes
global_rank	syndip	VQSR	False	198	49.0	1.03	1.07	10	6	2	2	1194	944	120	598	105	0.8872180451127819	0.6121919584954605	exomes
global_rank	syndip	VQSR	False	202	50.0	0.998	1.03	11	6	2	3	1205	950	122	592	103	0.8861940298507462	0.6160830090791181	exomes
global_rank	syndip	VQSR	False	206	51.0	0.953	0.989	9	7	2	0	1214	957	124	585	101	0.8852913968547641	0.6206225680933852	exomes
global_rank	syndip	VQSR	False	210	52.0	0.919	0.95	7	6	0	1	1221	963	124	579	101	0.8859245630174793	0.6245136186770428	exomes
global_rank	syndip	VQSR	False	214	53.0	0.869	0.901	7	4	2	1	1228	967	126	575	99	0.8847209515096066	0.6271076523994812	exomes
global_rank	syndip	VQSR	False	218	54.0	0.849	0.863	3	3	0	0	1231	970	126	572	99	0.885036496350365	0.62905317769131	exomes
global_rank	syndip	VQSR	False	222	55.0	0.786	0.821	3	1	1	1	1234	971	127	571	98	0.8843351548269581	0.6297016861219196	exomes
global_rank	syndip	VQSR	False	226	56.0	0.744	0.772	5	5	0	0	1239	976	127	566	98	0.8848594741613781	0.6329442282749675	exomes
global_rank	syndip	VQSR	False	230	57.0	0.702	0.733	4	1	0	3	1243	977	127	565	98	0.884963768115942	0.6335927367055771	exomes
global_rank	syndip	VQSR	False	234	58.0	0.669	0.693	6	4	1	1	1249	981	128	561	97	0.8845807033363391	0.6361867704280155	exomes
global_rank	syndip	VQSR	False	238	59.0	0.615	0.647	5	4	0	1	1254	985	128	557	97	0.8849955076370171	0.6387808041504539	exomes
global_rank	syndip	VQSR	False	242	60.0	0.566	0.586	4	3	0	1	1258	988	128	554	97	0.8853046594982079	0.6407263294422828	exomes
global_rank	syndip	VQSR	False	246	61.0	0.505	0.519	5	3	1	1	1263	991	129	551	96	0.8848214285714285	0.6426718547341116	exomes
global_rank	syndip	VQSR	False	250	62.0	0.446	0.477	4	2	1	1	1267	993	130	549	95	0.8842386464826358	0.6439688715953308	exomes
global_rank	syndip	VQSR	False	254	63.0	0.396	0.443	8	8	0	0	1275	1001	130	541	95	0.8850574712643678	0.6491569390402075	exomes
global_rank	syndip	VQSR	False	258	64.0	0.333	0.384	8	5	3	0	1283	1006	133	536	92	0.8832309043020193	0.6523994811932555	exomes
global_rank	syndip	VQSR	False	262	65.0	0.271	0.322	7	1	1	5	1290	1007	134	535	91	0.8825591586327782	0.6530479896238651	exomes
global_rank	syndip	VQSR	False	266	66.0	0.22	0.254	5	3	0	2	1295	1010	134	532	91	0.8828671328671329	0.6549935149156939	exomes
global_rank	syndip	VQSR	False	270	67.0	0.127	0.189	5	3	0	2	1300	1013	134	529	91	0.8831734960767219	0.6569390402075227	exomes
global_rank	syndip	VQSR	False	274	68.0	0.053	0.113	6	4	1	1	1306	1017	135	525	90	0.8828125	0.6595330739299611	exomes
global_rank	syndip	VQSR	False	278	69.0	-0.0188	0.028	4	1	1	2	1310	1018	136	524	89	0.8821490467937608	0.6601815823605707	exomes
global_rank	syndip	VQSR	False	282	70.0	-0.0903	-0.0474	8	4	0	4	1318	1022	136	520	89	0.8825561312607945	0.6627756160830091	exomes
global_rank	syndip	VQSR	False	286	71.0	-0.1681	-0.1191	3	0	1	2	1321	1022	137	520	88	0.8817946505608283	0.6627756160830091	exomes
global_rank	syndip	VQSR	False	290	72.0	-0.2558	-0.1983	11	4	3	4	1332	1026	140	516	85	0.8799313893653516	0.6653696498054474	exomes
global_rank	syndip	VQSR	False	294	73.0	-0.3252	-0.2761	12	3	3	6	1344	1029	143	513	82	0.8779863481228669	0.6673151750972762	exomes
global_rank	syndip	VQSR	False	298	74.0	-0.3975	-0.3402	8	3	2	3	1352	1032	145	510	80	0.8768054375531011	0.669260700389105	exomes
global_rank	syndip	VQSR	False	302	75.0	-0.4885	-0.4566	10	6	2	2	1362	1038	147	504	78	0.8759493670886076	0.6731517509727627	exomes
global_rank	syndip	VQSR	False	306	76.0	-0.5585	-0.5058	4	1	0	3	1366	1039	147	503	78	0.8760539629005059	0.6738002594033723	exomes
global_rank	syndip	VQSR	False	310	77.0	-0.6216	-0.5796	4	2	0	2	1370	1041	147	501	78	0.8762626262626263	0.6750972762645915	exomes
global_rank	syndip	VQSR	False	314	78.0	-0.7065	-0.6781	4	3	1	0	1374	1044	148	498	77	0.8758389261744967	0.6770428015564203	exomes
global_rank	syndip	VQSR	False	318	79.0	-0.746	-0.7432	2	1	0	1	1376	1045	148	497	77	0.875943000838223	0.6776913099870299	exomes
global_rank	syndip	VQSR	False	322	80.0	-0.875	-0.8228	8	2	0	6	1384	1047	148	495	77	0.8761506276150628	0.6789883268482491	exomes
global_rank	syndip	VQSR	False	326	81.0	-0.9464	-0.8897	5	2	0	3	1389	1049	148	493	77	0.8763575605680869	0.6802853437094682	exomes
global_rank	syndip	VQSR	False	329	82.0	-1.032	-0.9817	2	2	0	0	1391	1051	148	491	77	0.8765638031693077	0.6815823605706874	exomes
global_rank	syndip	VQSR	False	333	83.0	-1.108	-1.108	1	1	0	0	1392	1052	148	490	77	0.8766666666666667	0.682230869001297	exomes
global_rank	syndip	VQSR	False	336	84.0	-1.24	-1.208	3	0	2	1	1395	1052	150	490	75	0.8752079866888519	0.682230869001297	exomes
global_rank	syndip	VQSR	False	340	85.0	-1.313	-1.28	3	1	1	1	1398	1053	151	489	74	0.8745847176079734	0.6828793774319066	exomes
global_rank	syndip	VQSR	False	347	87.0	-1.611	-1.556	4	1	2	1	1402	1054	153	488	72	0.8732394366197183	0.6835278858625162	exomes
global_rank	syndip	VQSR	False	351	88.0	-1.76	-1.64	3	0	2	1	1405	1054	155	488	70	0.8717948717948718	0.6835278858625162	exomes
global_rank	syndip	VQSR	False	355	89.0	-1.852	-1.842	4	0	2	2	1409	1054	157	488	68	0.870355078447564	0.6835278858625162	exomes
global_rank	syndip	VQSR	False	358	90.0	-1.959	-1.951	2	1	1	0	1411	1055	158	487	67	0.8697444352844188	0.6841763942931258	exomes
global_rank	syndip	VQSR	False	362	91.0	-2.157	-2.074	3	0	2	1	1414	1055	160	487	65	0.8683127572016461	0.6841763942931258	exomes
global_rank	syndip	VQSR	False	369	93.0	-2.442	-2.336	2	0	1	1	1416	1055	161	487	64	0.8675986842105263	0.6841763942931258	exomes
global_rank	syndip	VQSR	False	373	94.0	-2.525	-2.525	1	0	1	0	1417	1055	162	487	63	0.866885784716516	0.6841763942931258	exomes
global_rank	syndip	VQSR	False	376	95.0	-3.078	-2.758	3	1	1	1	1420	1056	163	486	62	0.8662838392124692	0.6848249027237354	exomes
global_rank	syndip	VQSR	False	379	96.0	-4.116	-3.121	3	0	3	0	1423	1056	166	486	59	0.8641571194762684	0.6848249027237354	exomes
global_rank	syndip	VQSR	False	382	97.0	-6.728	-4.905	7	0	6	1	1430	1056	172	486	53	0.8599348534201955	0.6848249027237354	exomes
global_rank	syndip	VQSR	False	386	98.0	-34.64	-9.36	24	0	24	0	1454	1056	196	486	29	0.8434504792332268	0.6848249027237354	exomes
global_rank	syndip	VQSR	False	388	99.0	-123.0	-45.04	34	4	29	1	1488	1060	225	482	0	0.8249027237354085	0.6874189364461738	exomes
global_rank	syndip	VQSR	False	392	-1.0	-1.0	-1.0	279	0	0	279	1767	1060	225	482	0	0.8249027237354085	0.6874189364461738	exomes
global_rank	syndip	VQSR	True	396	0.0	5.71	9.0	18053	17978	5	70	18053	17978	5	22535	533	0.999721959628538	0.4437587934736998	exomes
global_rank	syndip	VQSR	True	400	1.0	5.19	5.71	6186	6120	2	64	24239	24098	7	16415	531	0.9997096038166355	0.5948214153481598	exomes
global_rank	syndip	VQSR	True	404	2.0	4.72	5.19	3699	3633	2	64	27938	27731	9	12782	529	0.9996755587599134	0.6844963345099104	exomes
global_rank	syndip	VQSR	True	408	3.0	4.32	4.72	2148	2084	3	61	30086	29815	12	10698	526	0.9995976799544037	0.7359366129390565	exomes
global_rank	syndip	VQSR	True	412	4.0	4.0	4.32	1415	1371	2	42	31501	31186	14	9327	524	0.9995512820512821	0.7697776022511292	exomes
global_rank	syndip	VQSR	True	416	5.0	3.71	4.0	1187	1134	1	52	32688	32320	15	8193	523	0.9995361063862688	0.7977686174808086	exomes
global_rank	syndip	VQSR	True	420	6.0	3.44	3.71	946	901	2	43	33634	33221	17	7292	521	0.999488537216439	0.8200083923678819	exomes
global_rank	syndip	VQSR	True	424	7.0	3.2	3.44	803	746	1	56	34437	33967	18	6546	520	0.9994703545681919	0.8384222348382001	exomes
global_rank	syndip	VQSR	True	428	8.0	3.0	3.2	707	650	1	56	35144	34617	19	5896	519	0.9994514378103707	0.8544664675536248	exomes
global_rank	syndip	VQSR	True	432	9.0	2.84	3.0	625	567	1	57	35769	35184	20	5329	518	0.9994318827405977	0.8684619751684645	exomes
global_rank	syndip	VQSR	True	436	10.0	2.68	2.84	482	430	1	51	36251	35614	21	4899	517	0.9994106917356531	0.8790758521955916	exomes
global_rank	syndip	VQSR	True	440	11.0	2.52	2.67	408	369	0	39	36659	35983	21	4530	517	0.9994167314742807	0.8881840396909634	exomes
global_rank	syndip	VQSR	True	444	12.0	2.37	2.52	375	313	1	61	37034	36296	22	4217	516	0.9993942397709125	0.895909954829314	exomes
global_rank	syndip	VQSR	True	448	13.0	2.22	2.36	291	229	0	62	37325	36525	22	3988	516	0.9993980354064629	0.9015624614321329	exomes
global_rank	syndip	VQSR	True	452	14.0	2.09	2.22	278	219	5	54	37603	36744	27	3769	511	0.9992657257077588	0.9069681336854837	exomes
global_rank	syndip	VQSR	True	456	15.0	1.97	2.09	242	181	0	61	37845	36925	27	3588	511	0.9992693223641481	0.9114358354108558	exomes
global_rank	syndip	VQSR	True	460	16.0	1.86	1.97	227	170	1	56	38072	37095	28	3418	510	0.9992457506128276	0.915632019351813	exomes
global_rank	syndip	VQSR	True	464	17.0	1.75	1.86	202	154	1	47	38274	37249	29	3264	509	0.9992220612693814	0.9194332683336213	exomes
global_rank	syndip	VQSR	True	468	18.0	1.64	1.75	201	161	0	40	38475	37410	29	3103	509	0.9992254066615027	0.9234073013600572	exomes
global_rank	syndip	VQSR	True	472	19.0	1.54	1.64	207	155	1	51	38682	37565	30	2948	508	0.9992020215454183	0.9272332337768123	exomes
global_rank	syndip	VQSR	True	476	20.0	1.44	1.54	198	152	1	45	38880	37717	31	2796	507	0.999178764437851	0.9309851158887271	exomes
global_rank	syndip	VQSR	True	480	21.0	1.33	1.44	170	136	1	33	39050	37853	32	2660	506	0.999155338524482	0.9343420630414928	exomes
global_rank	syndip	VQSR	True	484	22.0	1.23	1.33	145	110	0	35	39195	37963	32	2550	506	0.9991577839189367	0.9370572408856417	exomes
global_rank	syndip	VQSR	True	488	23.0	1.13	1.23	148	109	1	38	39343	38072	33	2441	505	0.9991339719196956	0.9397477352948437	exomes
global_rank	syndip	VQSR	True	492	24.0	1.03	1.13	127	91	0	36	39470	38163	33	2350	505	0.9991360351869306	0.9419939278750031	exomes
global_rank	syndip	VQSR	True	496	25.0	0.943	1.03	115	80	0	35	39585	38243	33	2270	505	0.9991378409447174	0.9439686026707477	exomes
global_rank	syndip	VQSR	True	500	26.0	0.857	0.942	81	52	2	27	39666	38295	35	2218	503	0.9990868771197495	0.9452521412879816	exomes
global_rank	syndip	VQSR	True	504	27.0	0.782	0.856	64	52	1	11	39730	38347	36	2166	502	0.9990620847771149	0.9465356799052156	exomes
global_rank	syndip	VQSR	True	508	28.0	0.713	0.78	60	43	1	16	39790	38390	37	2123	501	0.9990371353475421	0.9475970676079283	exomes
global_rank	syndip	VQSR	True	512	29.0	0.631	0.705	55	39	1	15	39845	38429	38	2084	500	0.9990121402760808	0.9485597215708538	exomes
global_rank	syndip	VQSR	True	516	30.0	0.559	0.63	53	37	2	14	39898	38466	40	2047	498	0.9989612008518153	0.9494730086638856	exomes
global_rank	syndip	VQSR	True	520	31.0	0.48	0.556	51	36	3	12	39949	38502	43	2011	495	0.9988844208068491	0.9503616123219707	exomes
global_rank	syndip	VQSR	True	524	32.0	0.405	0.48	23	13	1	9	39972	38515	44	1998	494	0.9988588915687647	0.9506824969762793	exomes
global_rank	syndip	VQSR	True	528	33.0	0.322	0.398	26	18	1	7	39998	38533	45	1980	493	0.9988335320649074	0.9511267988053217	exomes
global_rank	syndip	VQSR	True	532	34.0	0.245	0.32	22	16	2	4	40020	38549	47	1964	491	0.9987822572287284	0.9515217337644707	exomes
global_rank	syndip	VQSR	True	536	35.0	0.195	0.242	15	10	0	5	40035	38559	47	1954	491	0.9987825726570999	0.9517685681139387	exomes
global_rank	syndip	VQSR	True	540	36.0	0.122	0.176	21	15	3	3	40056	38574	50	1939	488	0.9987054681027341	0.9521388196381408	exomes
global_rank	syndip	VQSR	True	544	37.0	0.078	0.119	12	8	1	3	40068	38582	51	1931	487	0.9986798850723475	0.9523362871177153	exomes
global_rank	syndip	VQSR	True	548	38.0	0.024	0.058	12	8	0	4	40080	38590	51	1923	487	0.9986801583809943	0.9525337545972897	exomes
global_rank	syndip	VQSR	True	552	39.0	-0.0084	0.022	11	8	1	2	40091	38598	52	1915	486	0.9986545924967658	0.9527312220768642	exomes
global_rank	syndip	VQSR	True	556	40.0	-0.0432	-0.0166	7	4	0	3	40098	38602	52	1911	486	0.9986547317224608	0.9528299558166514	exomes
global_rank	syndip	VQSR	True	560	41.0	-0.0735	-0.0453	11	7	2	2	40109	38609	54	1904	484	0.9986033158316737	0.9530027398612791	exomes
global_rank	syndip	VQSR	True	564	42.0	-0.1038	-0.0793	6	3	1	2	40115	38612	55	1901	483	0.9985775984689788	0.9530767901661196	exomes
global_rank	syndip	VQSR	True	568	43.0	-0.1257	-0.1087	8	5	0	3	40123	38617	55	1896	483	0.9985777823748448	0.9532002073408535	exomes
global_rank	syndip	VQSR	True	572	44.0	-0.1564	-0.1365	5	5	0	0	40128	38622	55	1891	483	0.9985779662331619	0.9533236245155876	exomes
global_rank	syndip	VQSR	True	576	45.0	-0.1844	-0.1692	2	2	0	0	40130	38624	55	1889	483	0.9985780397631789	0.9533729913854811	exomes
global_rank	syndip	VQSR	True	580	46.0	-0.2085	-0.1916	7	5	1	1	40137	38629	56	1884	482	0.9985524104950239	0.9534964085602152	exomes
global_rank	syndip	VQSR	True	584	47.0	-0.2377	-0.2174	10	7	0	3	40147	38636	56	1877	482	0.9985526723870568	0.9536691926048428	exomes
global_rank	syndip	VQSR	True	588	48.0	-0.2628	-0.2405	6	4	1	1	40153	38640	57	1873	481	0.9985270175982635	0.9537679263446301	exomes
global_rank	syndip	VQSR	True	592	49.0	-0.2862	-0.2691	5	2	1	2	40158	38642	58	1871	480	0.9985012919896641	0.9538172932145237	exomes
global_rank	syndip	VQSR	True	596	50.0	-0.3125	-0.288	5	2	1	2	40163	38644	59	1869	479	0.9984755703692221	0.9538666600844173	exomes
global_rank	syndip	VQSR	True	600	51.0	-0.3359	-0.3141	6	2	3	1	40169	38646	62	1867	476	0.99839826392477	0.953916026954311	exomes
global_rank	syndip	VQSR	True	603	52.0	-0.3543	-0.3443	4	2	1	1	40173	38648	63	1865	475	0.9983725556043502	0.9539653938242045	exomes
global_rank	syndip	VQSR	True	607	53.0	-0.3795	-0.3702	3	1	1	1	40176	38649	64	1864	474	0.9983468085655981	0.9539900772591514	exomes
global_rank	syndip	VQSR	True	610	54.0	-0.4076	-0.3879	7	4	3	0	40183	38653	67	1860	471	0.9982696280991735	0.9540888109989386	exomes
global_rank	syndip	VQSR	True	614	55.0	-0.4318	-0.4258	3	2	1	0	40186	38655	68	1858	470	0.9982439377114376	0.9541381778688323	exomes
global_rank	syndip	VQSR	True	617	56.0	-0.4617	-0.443	5	3	2	0	40191	38658	70	1855	468	0.9981925222061557	0.9542122281736727	exomes
global_rank	syndip	VQSR	True	621	57.0	-0.4857	-0.4702	4	2	1	1	40195	38660	71	1853	467	0.9981668430972606	0.9542615950435662	exomes
global_rank	syndip	VQSR	True	625	58.0	-0.5206	-0.4989	4	1	2	1	40199	38661	73	1852	465	0.9981153508545464	0.9542862784785131	exomes
global_rank	syndip	VQSR	True	629	59.0	-0.5505	-0.5321	6	3	1	2	40205	38664	74	1849	464	0.9980897310134751	0.9543603287833535	exomes
global_rank	syndip	VQSR	True	633	60.0	-0.5782	-0.5563	8	8	0	0	40213	38672	74	1841	464	0.9980901254323027	0.9545577962629279	exomes
global_rank	syndip	VQSR	True	637	61.0	-0.6062	-0.587	9	6	3	0	40222	38678	77	1835	461	0.9980131595923106	0.9547058968726088	exomes
global_rank	syndip	VQSR	True	641	62.0	-0.6391	-0.6232	6	3	2	1	40228	38681	79	1832	459	0.9979618163054695	0.9547799471774492	exomes
global_rank	syndip	VQSR	True	644	63.0	-0.6737	-0.6418	11	4	4	3	40239	38685	83	1828	455	0.9978590590177466	0.9548786809172365	exomes
global_rank	syndip	VQSR	True	648	64.0	-0.6968	-0.6764	5	5	0	0	40244	38690	83	1823	455	0.9978593351043252	0.9550020980919705	exomes
global_rank	syndip	VQSR	True	652	65.0	-0.7381	-0.7083	11	9	2	0	40255	38699	85	1814	453	0.9978083745874587	0.9552242490064917	exomes
global_rank	syndip	VQSR	True	656	66.0	-0.7735	-0.7453	8	4	3	1	40263	38703	88	1810	450	0.997731432548787	0.955322982746279	exomes
global_rank	syndip	VQSR	True	660	67.0	-0.8077	-0.7894	5	2	3	0	40268	38705	91	1808	447	0.9976543973605526	0.9553723496161726	exomes
global_rank	syndip	VQSR	True	664	68.0	-0.8474	-0.8264	3	2	0	1	40271	38707	91	1806	447	0.9976545182741379	0.9554217164860662	exomes
global_rank	syndip	VQSR	True	668	69.0	-0.8855	-0.8523	9	6	2	1	40280	38713	93	1800	445	0.9976034633819513	0.9555698170957471	exomes
global_rank	syndip	VQSR	True	672	70.0	-0.924	-0.8952	5	4	1	0	40285	38717	94	1796	444	0.9975780062353456	0.9556685508355343	exomes
global_rank	syndip	VQSR	True	676	71.0	-0.9696	-0.931	6	3	2	1	40291	38720	96	1793	442	0.9975267930750206	0.9557426011403747	exomes
global_rank	syndip	VQSR	True	680	72.0	-0.9925	-0.9925	1	0	1	0	40292	38720	97	1793	441	0.9975010948811088	0.9557426011403747	exomes
global_rank	syndip	VQSR	True	684	73.0	-1.059	-1.025	8	4	3	1	40300	38724	100	1789	438	0.997424273645168	0.9558413348801619	exomes
global_rank	syndip	VQSR	True	688	74.0	-1.107	-1.065	7	3	3	1	40307	38727	103	1786	435	0.9973474117950039	0.9559153851850023	exomes
global_rank	syndip	VQSR	True	692	75.0	-1.15	-1.116	8	4	4	0	40315	38731	107	1782	431	0.9972449662701478	0.9560141189247896	exomes
global_rank	syndip	VQSR	True	695	76.0	-1.201	-1.161	7	4	2	1	40322	38735	109	1778	429	0.9971939038204098	0.9561128526645768	exomes
global_rank	syndip	VQSR	True	699	77.0	-1.237	-1.216	4	3	1	0	40326	38738	110	1775	428	0.9971684514003295	0.9561869029694172	exomes
global_rank	syndip	VQSR	True	703	78.0	-1.308	-1.274	8	5	3	0	40334	38743	113	1770	425	0.9970918262301832	0.9563103201441513	exomes
global_rank	syndip	VQSR	True	706	79.0	-1.368	-1.32	10	5	5	0	40344	38748	118	1765	420	0.9969639273400916	0.9564337373188853	exomes
global_rank	syndip	VQSR	True	710	80.0	-1.429	-1.38	7	3	4	0	40351	38751	122	1762	416	0.9968615748720191	0.9565077876237257	exomes
global_rank	syndip	VQSR	True	714	81.0	-1.497	-1.443	5	2	3	0	40356	38753	125	1760	413	0.9967848140336437	0.9565571544936193	exomes
global_rank	syndip	VQSR	True	718	82.0	-1.565	-1.501	15	6	9	0	40371	38759	134	1754	404	0.9965546499370067	0.9567052551033002	exomes
global_rank	syndip	VQSR	True	722	83.0	-1.636	-1.568	10	5	3	2	40381	38764	137	1749	401	0.9964782396339426	0.9568286722780343	exomes
global_rank	syndip	VQSR	True	726	84.0	-1.711	-1.645	15	9	5	1	40396	38773	142	1740	396	0.9963510214570217	0.9570508231925555	exomes
global_rank	syndip	VQSR	True	730	85.0	-1.786	-1.718	11	4	7	0	40407	38777	149	1736	389	0.9961722242203155	0.9571495569323427	exomes
global_rank	syndip	VQSR	True	734	86.0	-1.874	-1.817	12	4	8	0	40419	38781	157	1732	381	0.9959679490472032	0.9572482906721299	exomes
global_rank	syndip	VQSR	True	738	87.0	-1.949	-1.89	12	4	7	1	40431	38785	164	1728	374	0.9957893655806311	0.9573470244119172	exomes
global_rank	syndip	VQSR	True	742	88.0	-2.06	-1.974	14	9	4	1	40445	38794	168	1719	370	0.9956881063600431	0.9575691753264385	exomes
global_rank	syndip	VQSR	True	746	89.0	-2.156	-2.072	19	11	7	1	40464	38805	175	1708	363	0.995510518214469	0.9578406931108533	exomes
global_rank	syndip	VQSR	True	750	90.0	-2.301	-2.174	13	7	4	2	40477	38812	179	1701	359	0.9954091969941782	0.9580134771554809	exomes
global_rank	syndip	VQSR	True	754	91.0	-2.426	-2.329	13	7	4	2	40490	38819	183	1694	355	0.9953079329265165	0.9581862612001086	exomes
global_rank	syndip	VQSR	True	758	92.0	-2.691	-2.491	13	6	5	2	40503	38825	188	1688	350	0.99518109348166	0.9583343618097895	exomes
global_rank	syndip	VQSR	True	762	93.0	-2.996	-2.7	17	6	9	2	40520	38831	197	1682	341	0.9949523419083734	0.9584824624194703	exomes
global_rank	syndip	VQSR	True	766	94.0	-3.436	-3.016	12	4	6	2	40532	38835	203	1678	335	0.9947999385214407	0.9585811961592575	exomes
global_rank	syndip	VQSR	True	770	95.0	-4.084	-3.458	20	7	9	4	40552	38842	212	1671	326	0.9945716187842475	0.9587539802038851	exomes
global_rank	syndip	VQSR	True	774	96.0	-5.266	-4.201	26	11	9	6	40578	38853	221	1660	317	0.9943440651072324	0.9590254979883001	exomes
global_rank	syndip	VQSR	True	778	97.0	-7.982	-5.499	22	9	11	2	40600	38862	232	1651	306	0.9940655855118432	0.9592476489028213	exomes
global_rank	syndip	VQSR	True	782	98.0	-19.3	-8.513	58	7	47	4	40658	38869	279	1644	259	0.9928731991417186	0.9594204329474489	exomes
global_rank	syndip	VQSR	True	786	99.0	-1134.0	-20.55	295	24	259	12	40953	38893	538	1620	0	0.9863559128604398	0.9600128353861723	exomes
global_rank	syndip	VQSR	True	790	-1.0	-1.0	-1.0	98	0	0	98	41051	38893	538	1620	0	0.9863559128604398	0.9600128353861723	exomes
truth_sample_rank	NA12878	RF	False	791	0.0	0.8995855042968076	0.9173004202466639	28	25	1	2	28	25	1	2409	414	0.9615384615384616	0.010271158586688579	exomes
truth_sample_rank	NA12878	RF	False	795	1.0	0.894915503513314	0.8995855042968076	28	26	0	2	56	51	1	2383	414	0.9807692307692307	0.0209531635168447	exomes
truth_sample_rank	NA12878	RF	False	799	2.0	0.8915850955610288	0.8947663236417351	29	26	0	3	85	77	1	2357	414	0.9871794871794872	0.031635168447000823	exomes
truth_sample_rank	NA12878	RF	False	803	3.0	0.8854343058072721	0.8915819381209856	28	21	0	7	113	98	1	2336	414	0.98989898989899	0.04026294165981923	exomes
truth_sample_rank	NA12878	RF	False	807	4.0	0.881445808270629	0.8854343058072721	29	24	2	3	142	122	3	2312	412	0.976	0.05012325390304026	exomes
truth_sample_rank	NA12878	RF	False	811	5.0	0.8775130441847449	0.881445808270629	28	19	0	9	170	141	3	2293	412	0.9791666666666666	0.05792933442892358	exomes
truth_sample_rank	NA12878	RF	False	815	6.0	0.8727033114913569	0.8772696292616012	29	25	0	4	199	166	3	2268	412	0.9822485207100592	0.06820049301561217	exomes
truth_sample_rank	NA12878	RF	False	819	7.0	0.8640115475328293	0.8726981087190661	28	22	0	6	227	188	3	2246	412	0.9842931937172775	0.07723911257189811	exomes
truth_sample_rank	NA12878	RF	False	823	8.0	0.8565693820209032	0.8639876662756792	29	23	1	5	256	211	4	2223	411	0.9813953488372092	0.08668857847165161	exomes
truth_sample_rank	NA12878	RF	False	827	9.0	0.8529602784106866	0.8565693820209032	28	28	0	0	284	239	4	2195	411	0.9835390946502057	0.09819227608874281	exomes
truth_sample_rank	NA12878	RF	False	831	10.0	0.8522404585548107	0.8528703545378696	29	29	0	0	313	268	4	2166	411	0.9852941176470589	0.11010682004930156	exomes
truth_sample_rank	NA12878	RF	False	835	11.0	0.8513364129733192	0.8522404585548107	28	28	0	0	341	296	4	2138	411	0.9866666666666667	0.12161051766639278	exomes
truth_sample_rank	NA12878	RF	False	839	12.0	0.8513364129733192	0.8513364129733192	29	29	0	0	370	325	4	2109	411	0.9878419452887538	0.13352506162695152	exomes
truth_sample_rank	NA12878	RF	False	843	13.0	0.8513364129733192	0.8513364129733192	28	28	0	0	398	353	4	2081	411	0.988795518207283	0.14502875924404274	exomes
truth_sample_rank	NA12878	RF	False	847	14.0	0.8513253083921826	0.8513364129733192	29	29	0	0	427	382	4	2052	411	0.9896373056994818	0.15694330320460148	exomes
truth_sample_rank	NA12878	RF	False	851	15.0	0.8499710214155205	0.8513253083921826	28	26	0	2	455	408	4	2026	411	0.9902912621359223	0.1676253081347576	exomes
truth_sample_rank	NA12878	RF	False	855	16.0	0.8462433543386773	0.8499476407521649	29	28	0	1	484	436	4	1998	411	0.990909090909091	0.1791290057518488	exomes
truth_sample_rank	NA12878	RF	False	859	17.0	0.8436255856763092	0.8462359229086819	28	27	0	1	512	463	4	1971	411	0.9914346895074947	0.19022185702547248	exomes
truth_sample_rank	NA12878	RF	False	863	18.0	0.8427215400948176	0.8436255856763092	29	29	0	0	541	492	4	1942	411	0.9919354838709677	0.20213640098603122	exomes
truth_sample_rank	NA12878	RF	False	867	19.0	0.8427215400948176	0.8427215400948176	28	27	1	0	569	519	5	1915	410	0.9904580152671756	0.2132292522596549	exomes
truth_sample_rank	NA12878	RF	False	871	20.0	0.8427215400948176	0.8427215400948176	29	28	0	1	598	547	5	1887	410	0.9909420289855072	0.2247329498767461	exomes
truth_sample_rank	NA12878	RF	False	875	21.0	0.842675070050757	0.8427215400948176	28	27	0	1	626	574	5	1860	410	0.9913644214162349	0.23582580115036977	exomes
truth_sample_rank	NA12878	RF	False	879	22.0	0.8412563312560175	0.842675070050757	29	29	0	0	655	603	5	1831	410	0.9917763157894737	0.24774034511092852	exomes
truth_sample_rank	NA12878	RF	False	883	23.0	0.8405324994741943	0.8412563312560175	28	27	0	1	683	630	5	1804	410	0.9921259842519685	0.25883319638455216	exomes
truth_sample_rank	NA12878	RF	False	887	24.0	0.840303728911156	0.8405324994741943	29	27	0	2	712	657	5	1777	410	0.9924471299093656	0.26992604765817585	exomes
truth_sample_rank	NA12878	RF	False	891	25.0	0.840303728911156	0.840303728911156	28	26	1	1	740	683	6	1751	409	0.9912917271407837	0.280608052588332	exomes
truth_sample_rank	NA12878	RF	False	895	26.0	0.8369129664119979	0.840303728911156	29	28	0	1	769	711	6	1723	409	0.9916317991631799	0.2921117502054232	exomes
truth_sample_rank	NA12878	RF	False	899	27.0	0.8335357184683897	0.8369129664119979	28	24	2	2	797	735	8	1699	407	0.9892328398384926	0.3019720624486442	exomes
truth_sample_rank	NA12878	RF	False	903	28.0	0.8323624512358936	0.8332930873363938	29	29	0	0	826	764	8	1670	407	0.9896373056994818	0.31388660640920296	exomes
truth_sample_rank	NA12878	RF	False	907	29.0	0.832267823137516	0.8323504477516822	28	28	0	0	854	792	8	1642	407	0.99	0.32539030402629415	exomes
truth_sample_rank	NA12878	RF	False	911	30.0	0.8318970003750621	0.832267823137516	29	29	0	0	883	821	8	1613	407	0.9903498190591074	0.3373048479868529	exomes
truth_sample_rank	NA12878	RF	False	915	31.0	0.8315439913556929	0.8318970003750621	28	28	0	0	911	849	8	1585	407	0.9906651108518086	0.34880854560394414	exomes
truth_sample_rank	NA12878	RF	False	919	32.0	0.8315439913556929	0.8315439913556929	29	29	0	0	940	878	8	1556	407	0.9909706546275395	0.3607230895645029	exomes
truth_sample_rank	NA12878	RF	False	923	33.0	0.831268750748594	0.8315439913556929	28	28	0	0	968	906	8	1528	407	0.9912472647702407	0.3722267871815941	exomes
truth_sample_rank	NA12878	RF	False	927	34.0	0.8309687209621881	0.831268750748594	29	29	0	0	997	935	8	1499	407	0.9915164369034994	0.3841413311421528	exomes
truth_sample_rank	NA12878	RF	False	931	35.0	0.830515273585568	0.8309687209621881	28	28	0	0	1025	963	8	1471	407	0.9917610710607621	0.39564502875924407	exomes
truth_sample_rank	NA12878	RF	False	935	36.0	0.8301545662858816	0.830515273585568	29	29	0	0	1054	992	8	1442	407	0.992	0.4075595727198028	exomes
truth_sample_rank	NA12878	RF	False	939	37.0	0.829579948741034	0.8301545662858816	28	27	1	0	1082	1019	9	1415	406	0.9912451361867705	0.41865242399342645	exomes
truth_sample_rank	NA12878	RF	False	943	38.0	0.8267268543740394	0.8292496719691769	29	28	0	1	1111	1047	9	1387	406	0.9914772727272727	0.43015612161051764	exomes
truth_sample_rank	NA12878	RF	False	947	39.0	0.8239948613224766	0.8265468309334205	28	28	0	0	1139	1075	9	1359	406	0.9916974169741697	0.4416598192276089	exomes
truth_sample_rank	NA12878	RF	False	951	40.0	0.8227478807683422	0.8239795742564728	29	28	0	1	1168	1103	9	1331	406	0.9919064748201439	0.4531635168447001	exomes
truth_sample_rank	NA12878	RF	False	955	41.0	0.8222944333917219	0.8227478807683422	28	28	0	0	1196	1131	9	1303	406	0.9921052631578947	0.46466721446179127	exomes
truth_sample_rank	NA12878	RF	False	959	42.0	0.821366153978848	0.8222944333917219	29	29	0	0	1225	1160	9	1274	406	0.9923011120615911	0.47658175842235007	exomes
truth_sample_rank	NA12878	RF	False	963	43.0	0.8205519993025415	0.821366153978848	28	28	0	0	1253	1188	9	1246	406	0.9924812030075187	0.48808545603944126	exomes
truth_sample_rank	NA12878	RF	False	967	44.0	0.8186877873662333	0.8205519993025415	29	27	0	2	1282	1215	9	1219	406	0.9926470588235294	0.4991783073130649	exomes
truth_sample_rank	NA12878	RF	False	971	45.0	0.8175312203447743	0.8186693214309925	28	24	1	3	1310	1239	10	1195	405	0.9919935948759008	0.5090386195562859	exomes
truth_sample_rank	NA12878	RF	False	975	46.0	0.8145185102372824	0.8174993271136409	29	27	0	2	1339	1266	10	1168	405	0.9921630094043887	0.5201314708299096	exomes
truth_sample_rank	NA12878	RF	False	979	47.0	0.8121870706837874	0.8145167097374099	28	25	2	1	1367	1291	12	1143	403	0.9907904834996163	0.5304026294165982	exomes
truth_sample_rank	NA12878	RF	False	983	48.0	0.8099475010461071	0.8121870706837874	29	27	0	2	1396	1318	12	1116	403	0.9909774436090225	0.5414954806902219	exomes
truth_sample_rank	NA12878	RF	False	987	49.0	0.8068328267742487	0.8099010310020466	28	26	0	2	1424	1344	12	1090	403	0.9911504424778761	0.5521774856203779	exomes
truth_sample_rank	NA12878	RF	False	991	50.0	0.8040256000053696	0.8064291224512771	28	27	0	1	1452	1371	12	1063	403	0.9913232104121475	0.5632703368940016	exomes
truth_sample_rank	NA12878	RF	False	995	51.0	0.8022070466471528	0.8039229942064442	29	26	1	2	1481	1397	13	1037	402	0.9907801418439717	0.5739523418241578	exomes
truth_sample_rank	NA12878	RF	False	999	52.0	0.8019415844275386	0.8021367853388144	28	28	0	0	1509	1425	13	1009	402	0.9909596662030598	0.585456039441249	exomes
truth_sample_rank	NA12878	RF	False	1003	53.0	0.801291519661126	0.8019415844275386	29	29	0	0	1538	1454	13	980	402	0.9911383776414451	0.5973705834018077	exomes
truth_sample_rank	NA12878	RF	False	1007	54.0	0.8002793814422372	0.8012827040308531	28	28	0	0	1566	1482	13	952	402	0.991304347826087	0.608874281018899	exomes
truth_sample_rank	NA12878	RF	False	1011	55.0	0.7985916343557342	0.8002508147065325	29	27	0	2	1595	1509	13	925	402	0.9914586070959264	0.6199671322925226	exomes
truth_sample_rank	NA12878	RF	False	1015	56.0	0.7963618541316752	0.7985916343557342	28	27	0	1	1623	1536	13	898	402	0.9916074887023887	0.6310599835661462	exomes
truth_sample_rank	NA12878	RF	False	1019	57.0	0.7945144354724042	0.7960543702233869	29	27	1	1	1652	1563	14	871	401	0.9911223842739378	0.6421528348397699	exomes
truth_sample_rank	NA12878	RF	False	1023	58.0	0.7914552533590262	0.7943340595912499	28	28	0	0	1680	1591	14	843	401	0.9912772585669782	0.6536565324568612	exomes
truth_sample_rank	NA12878	RF	False	1027	59.0	0.7903809568677698	0.7910398372644553	29	29	0	0	1709	1620	14	814	401	0.9914320685434517	0.6655710764174199	exomes
truth_sample_rank	NA12878	RF	False	1031	60.0	0.7890114987930638	0.7903809568677698	28	24	2	2	1737	1644	16	790	399	0.9903614457831326	0.6754313886606409	exomes
truth_sample_rank	NA12878	RF	False	1035	61.0	0.7865651233959886	0.7889690437821968	29	27	0	2	1766	1671	16	763	399	0.990515708358032	0.6865242399342646	exomes
truth_sample_rank	NA12878	RF	False	1039	62.0	0.7848226893068082	0.7865651233959886	28	26	1	1	1794	1697	17	737	398	0.9900816802800467	0.6972062448644207	exomes
truth_sample_rank	NA12878	RF	False	1043	63.0	0.7833374477022218	0.7848226893068082	29	26	0	3	1823	1723	17	711	398	0.9902298850574712	0.7078882497945769	exomes
truth_sample_rank	NA12878	RF	False	1047	64.0	0.77862307627139	0.7833374477022218	28	18	0	10	1851	1741	17	693	398	0.9903299203640501	0.7152834839769926	exomes
truth_sample_rank	NA12878	RF	False	1051	65.0	0.7696852733189665	0.7779211693473785	29	20	1	8	1880	1761	18	673	397	0.9898819561551433	0.7235004108463434	exomes
truth_sample_rank	NA12878	RF	False	1055	66.0	0.7636707180934064	0.7696789830081476	28	24	1	3	1908	1785	19	649	396	0.9894678492239468	0.7333607230895645	exomes
truth_sample_rank	NA12878	RF	False	1059	67.0	0.7588281309687179	0.7635888539111007	29	27	0	2	1937	1812	19	622	396	0.9896231567449482	0.7444535743631882	exomes
truth_sample_rank	NA12878	RF	False	1063	68.0	0.7515975435507185	0.7586178060363055	28	28	0	0	1965	1840	19	594	396	0.9897794513179129	0.7559572719802794	exomes
truth_sample_rank	NA12878	RF	False	1067	69.0	0.745854124978648	0.7515241602196089	29	27	2	0	1994	1867	21	567	394	0.9888771186440678	0.7670501232539031	exomes
truth_sample_rank	NA12878	RF	False	1071	70.0	0.734325570956229	0.7454869881875393	28	24	2	2	2022	1891	23	543	392	0.9879832810867294	0.7769104354971241	exomes
truth_sample_rank	NA12878	RF	False	1075	71.0	0.7218487661138625	0.734152118767405	29	22	0	7	2051	1913	23	521	392	0.9881198347107438	0.7859490550534101	exomes
truth_sample_rank	NA12878	RF	False	1079	72.0	0.7035459197364852	0.7205169947558526	28	24	0	4	2079	1937	23	497	392	0.988265306122449	0.7958093672966311	exomes
truth_sample_rank	NA12878	RF	False	1083	73.0	0.6845963643428322	0.703527458759284	29	27	0	2	2108	1964	23	470	392	0.98842476094615	0.8069022185702547	exomes
truth_sample_rank	NA12878	RF	False	1087	74.0	0.6586551585508296	0.6845963643428322	28	23	0	5	2136	1987	23	447	392	0.9885572139303482	0.8163516844700082	exomes
truth_sample_rank	NA12878	RF	False	1091	75.0	0.6002818733348751	0.6585856005522057	29	24	1	4	2165	2011	24	423	391	0.9882063882063882	0.8262119967132292	exomes
truth_sample_rank	NA12878	RF	False	1095	76.0	0.5437534852077687	0.590500764801989	28	24	2	2	2193	2035	26	399	389	0.987384764677341	0.8360723089564502	exomes
truth_sample_rank	NA12878	RF	False	1099	77.0	0.5180710851576443	0.5433928290278562	29	29	0	0	2222	2064	26	370	389	0.9875598086124402	0.847986852917009	exomes
truth_sample_rank	NA12878	RF	False	1103	78.0	0.49486593412098545	0.518006509471813	28	25	1	2	2250	2089	27	345	388	0.9872400756143668	0.8582580115036976	exomes
truth_sample_rank	NA12878	RF	False	1107	79.0	0.44614299135094704	0.4929158217648072	29	26	0	3	2279	2115	27	319	388	0.9873949579831933	0.8689400164338538	exomes
truth_sample_rank	NA12878	RF	False	1111	80.0	0.4074882747391433	0.4460729747872638	28	23	3	2	2307	2138	30	296	385	0.9861623616236163	0.8783894823336073	exomes
truth_sample_rank	NA12878	RF	False	1115	81.0	0.35451450277293484	0.40741963371744677	29	19	3	7	2336	2157	33	277	382	0.9849315068493151	0.8861955628594905	exomes
truth_sample_rank	NA12878	RF	False	1119	82.0	0.288527941800039	0.34032264301420484	28	10	12	6	2364	2167	45	267	370	0.9796564195298373	0.8903040262941659	exomes
truth_sample_rank	NA12878	RF	False	1123	83.0	0.23867259056510237	0.2873369456870789	29	11	17	1	2393	2178	62	256	353	0.9723214285714286	0.8948233360723089	exomes
truth_sample_rank	NA12878	RF	False	1127	84.0	0.21812482995838461	0.237839365999378	28	4	23	1	2421	2182	85	252	330	0.9625055138950155	0.8964667214461791	exomes
truth_sample_rank	NA12878	RF	False	1131	85.0	0.16725794121388174	0.21333670745397704	29	2	27	0	2450	2184	112	250	303	0.9512195121951219	0.8972884141331142	exomes
truth_sample_rank	NA12878	RF	False	1135	86.0	0.1614927870501372	0.16725794121388174	28	0	28	0	2478	2184	140	250	275	0.9397590361445783	0.8972884141331142	exomes
truth_sample_rank	NA12878	RF	False	1139	87.0	0.15904666191554362	0.16119313716179112	29	0	29	0	2507	2184	169	250	246	0.9281767955801105	0.8972884141331142	exomes
truth_sample_rank	NA12878	RF	False	1143	88.0	0.1568612046533254	0.15859636328756124	28	0	28	0	2535	2184	197	250	218	0.9172616547669047	0.8972884141331142	exomes
truth_sample_rank	NA12878	RF	False	1147	89.0	0.15242849221398547	0.15684165378439963	29	0	29	0	2564	2184	226	250	189	0.9062240663900415	0.8972884141331142	exomes
truth_sample_rank	NA12878	RF	False	1151	90.0	0.14611442399793245	0.1522664678027409	28	3	25	0	2592	2187	251	247	164	0.8970467596390485	0.8985209531635169	exomes
truth_sample_rank	NA12878	RF	False	1155	91.0	0.138173897522347	0.14572661499450393	29	1	28	0	2621	2188	279	246	136	0.8869071747061208	0.8989317995069844	exomes
truth_sample_rank	NA12878	RF	False	1159	92.0	0.12683128147818598	0.13816040182481013	28	0	28	0	2649	2188	307	246	108	0.8769539078156313	0.8989317995069844	exomes
truth_sample_rank	NA12878	RF	False	1163	93.0	0.11699996874085944	0.12624805660490818	29	0	29	0	2678	2188	336	246	79	0.866877971473851	0.8989317995069844	exomes
truth_sample_rank	NA12878	RF	False	1167	94.0	0.10469449955349679	0.11661042309465207	28	0	28	0	2706	2188	364	246	51	0.8573667711598746	0.8989317995069844	exomes
truth_sample_rank	NA12878	RF	False	1171	95.0	0.05838764370464184	0.10465443995547977	29	0	29	0	2735	2188	393	246	22	0.8477334366524603	0.8989317995069844	exomes
truth_sample_rank	NA12878	RF	False	1175	96.0	0.024927281774009356	0.05737125802534152	28	0	22	6	2763	2188	415	246	0	0.8405685747214752	0.8989317995069844	exomes
truth_sample_rank	NA12878	RF	False	1179	97.0	-1.0	-1.0	29	0	0	29	2792	2188	415	246	0	0.8405685747214752	0.8989317995069844	exomes
truth_sample_rank	NA12878	RF	False	1183	98.0	-1.0	-1.0	28	0	0	28	2820	2188	415	246	0	0.8405685747214752	0.8989317995069844	exomes
truth_sample_rank	NA12878	RF	False	1187	99.0	-1.0	-1.0	28	0	0	28	2848	2188	415	246	0	0.8405685747214752	0.8989317995069844	exomes
truth_sample_rank	NA12878	RF	False	1191	100.0	-1.0	-1.0	1	0	0	1	2849	2188	415	246	0	0.8405685747214752	0.8989317995069844	exomes
truth_sample_rank	NA12878	RF	True	1195	0.0	0.940326909875765	0.940326909875765	387	383	0	4	387	383	0	37991	339	1.0	0.009980716109866054	exomes
truth_sample_rank	NA12878	RF	True	1199	1.0	0.940326909875765	0.940326909875765	387	383	0	4	774	766	0	37608	339	1.0	0.01996143221973211	exomes
truth_sample_rank	NA12878	RF	True	1203	2.0	0.940326909875765	0.940326909875765	387	386	0	1	1161	1152	0	37222	339	1.0	0.03002032626257362	exomes
truth_sample_rank	NA12878	RF	True	1207	3.0	0.940326909875765	0.940326909875765	387	386	0	1	1548	1538	0	36836	339	1.0	0.04007922030541512	exomes
truth_sample_rank	NA12878	RF	True	1211	4.0	0.940326909875765	0.940326909875765	387	384	0	3	1935	1922	0	36452	339	1.0	0.050085995726272994	exomes
truth_sample_rank	NA12878	RF	True	1215	5.0	0.940326909875765	0.940326909875765	387	384	0	3	2322	2306	0	36068	339	1.0	0.06009277114713087	exomes
truth_sample_rank	NA12878	RF	True	1219	6.0	0.940326909875765	0.940326909875765	387	383	0	4	2709	2689	0	35685	339	1.0	0.07007348725699693	exomes
truth_sample_rank	NA12878	RF	True	1223	7.0	0.940326909875765	0.940326909875765	388	380	0	8	3097	3069	0	35305	339	1.0	0.07997602543388753	exomes
truth_sample_rank	NA12878	RF	True	1227	8.0	0.940326909875765	0.940326909875765	387	384	0	3	3484	3453	0	34921	339	1.0	0.0899828008547454	exomes
truth_sample_rank	NA12878	RF	True	1231	9.0	0.940326909875765	0.940326909875765	387	385	0	2	3871	3838	0	34536	339	1.0	0.10001563558659508	exomes
truth_sample_rank	NA12878	RF	True	1235	10.0	0.940326909875765	0.940326909875765	387	384	0	3	4258	4222	0	34152	339	1.0	0.11002241100745297	exomes
truth_sample_rank	NA12878	RF	True	1239	11.0	0.940326909875765	0.940326909875765	387	386	0	1	4645	4608	0	33766	339	1.0	0.12008130505029448	exomes
truth_sample_rank	NA12878	RF	True	1243	12.0	0.940326909875765	0.940326909875765	387	387	0	0	5032	4995	0	33379	339	1.0	0.1301662584041278	exomes
truth_sample_rank	NA12878	RF	True	1247	13.0	0.940326909875765	0.940326909875765	387	387	0	0	5419	5382	0	32992	339	1.0	0.14025121175796113	exomes
truth_sample_rank	NA12878	RF	True	1251	14.0	0.940326909875765	0.940326909875765	387	384	0	3	5806	5766	0	32608	339	1.0	0.150257987178819	exomes
truth_sample_rank	NA12878	RF	True	1255	15.0	0.940326909875765	0.940326909875765	388	383	0	5	6194	6149	0	32225	339	1.0	0.16023870328868506	exomes
truth_sample_rank	NA12878	RF	True	1259	16.0	0.940326909875765	0.940326909875765	387	383	0	4	6581	6532	0	31842	339	1.0	0.1702194193985511	exomes
truth_sample_rank	NA12878	RF	True	1263	17.0	0.940326909875765	0.940326909875765	387	386	0	1	6968	6918	0	31456	339	1.0	0.1802783134413926	exomes
truth_sample_rank	NA12878	RF	True	1267	18.0	0.940326909875765	0.940326909875765	387	387	0	0	7355	7305	0	31069	339	1.0	0.19036326679522594	exomes
truth_sample_rank	NA12878	RF	True	1271	19.0	0.940326909875765	0.940326909875765	387	384	0	3	7742	7689	0	30685	339	1.0	0.20037004221608382	exomes
truth_sample_rank	NA12878	RF	True	1275	20.0	0.940326909875765	0.940326909875765	387	387	0	0	8129	8076	0	30298	339	1.0	0.21045499556991712	exomes
truth_sample_rank	NA12878	RF	True	1279	21.0	0.940326909875765	0.940326909875765	387	384	0	3	8516	8460	0	29914	339	1.0	0.220461770990775	exomes
truth_sample_rank	NA12878	RF	True	1283	22.0	0.940326909875765	0.940326909875765	387	384	0	3	8903	8844	0	29530	339	1.0	0.23046854641163286	exomes
truth_sample_rank	NA12878	RF	True	1287	23.0	0.940326909875765	0.940326909875765	388	386	0	2	9291	9230	0	29144	339	1.0	0.24052744045447438	exomes
truth_sample_rank	NA12878	RF	True	1291	24.0	0.940326909875765	0.940326909875765	387	385	0	2	9678	9615	0	28759	339	1.0	0.25056027518632407	exomes
truth_sample_rank	NA12878	RF	True	1295	25.0	0.940326909875765	0.940326909875765	387	386	0	1	10065	10001	0	28373	339	1.0	0.26061916922916556	exomes
truth_sample_rank	NA12878	RF	True	1299	26.0	0.940326909875765	0.940326909875765	387	383	0	4	10452	10384	0	27990	339	1.0	0.2705998853390316	exomes
truth_sample_rank	NA12878	RF	True	1303	27.0	0.940326909875765	0.940326909875765	387	386	0	1	10839	10770	0	27604	339	1.0	0.28065877938187317	exomes
truth_sample_rank	NA12878	RF	True	1307	28.0	0.940326909875765	0.940326909875765	387	382	0	5	11226	11152	0	27222	339	1.0	0.29061343618074736	exomes
truth_sample_rank	NA12878	RF	True	1311	29.0	0.940326909875765	0.940326909875765	387	381	0	6	11613	11533	0	26841	339	1.0	0.3005420336686298	exomes
truth_sample_rank	NA12878	RF	True	1315	30.0	0.940326909875765	0.940326909875765	388	388	0	0	12001	11921	0	26453	339	1.0	0.3106530463334549	exomes
truth_sample_rank	NA12878	RF	True	1319	31.0	0.940326909875765	0.940326909875765	387	383	0	4	12388	12304	0	26070	339	1.0	0.320633762443321	exomes
truth_sample_rank	NA12878	RF	True	1323	32.0	0.940326909875765	0.940326909875765	387	382	0	5	12775	12686	0	25688	339	1.0	0.33058841924219523	exomes
truth_sample_rank	NA12878	RF	True	1327	33.0	0.9398216346459711	0.940326909875765	387	379	0	8	13162	13065	0	25309	339	1.0	0.34046489810809405	exomes
truth_sample_rank	NA12878	RF	True	1331	34.0	0.9395401180862586	0.9398216346459711	387	372	0	15	13549	13437	0	24937	339	1.0	0.3501589617970501	exomes
truth_sample_rank	NA12878	RF	True	1335	35.0	0.9393634327490663	0.9395401180862586	387	385	0	2	13936	13822	0	24552	339	1.0	0.36019179652889977	exomes
truth_sample_rank	NA12878	RF	True	1339	36.0	0.9393634327490663	0.9393634327490663	387	387	0	0	14323	14209	0	24165	339	1.0	0.3702767498827331	exomes
truth_sample_rank	NA12878	RF	True	1343	37.0	0.9393634327490663	0.9393634327490663	387	387	0	0	14710	14596	0	23778	339	1.0	0.38036170323656643	exomes
truth_sample_rank	NA12878	RF	True	1347	38.0	0.9393634327490663	0.9393634327490663	388	388	0	0	15098	14984	0	23390	339	1.0	0.39047271590139154	exomes
truth_sample_rank	NA12878	RF	True	1351	39.0	0.9393634327490663	0.9393634327490663	387	386	0	1	15485	15370	0	23004	339	1.0	0.4005316099442331	exomes
truth_sample_rank	NA12878	RF	True	1355	40.0	0.9393634327490663	0.9393634327490663	387	386	0	1	15872	15756	0	22618	339	1.0	0.4105905039870746	exomes
truth_sample_rank	NA12878	RF	True	1359	41.0	0.9393634327490663	0.9393634327490663	387	386	0	1	16259	16142	0	22232	339	1.0	0.4206493980299161	exomes
truth_sample_rank	NA12878	RF	True	1363	42.0	0.9393634327490663	0.9393634327490663	387	386	0	1	16646	16528	0	21846	339	1.0	0.43070829207275757	exomes
truth_sample_rank	NA12878	RF	True	1367	43.0	0.9393634327490663	0.9393634327490663	387	387	0	0	17033	16915	0	21459	339	1.0	0.44079324542659093	exomes
truth_sample_rank	NA12878	RF	True	1371	44.0	0.9393634327490663	0.9393634327490663	387	386	0	1	17420	17301	0	21073	339	1.0	0.4508521394694324	exomes
truth_sample_rank	NA12878	RF	True	1375	45.0	0.9385435642385023	0.9393634327490663	387	383	0	4	17807	17684	0	20690	339	1.0	0.4608328555792985	exomes
truth_sample_rank	NA12878	RF	True	1379	46.0	0.9352891815965276	0.9383751826570771	388	369	0	19	18195	18053	0	20321	339	1.0	0.4704487413352791	exomes
truth_sample_rank	NA12878	RF	True	1383	47.0	0.9273915584490658	0.9352891815965276	387	372	1	14	18582	18425	1	19949	338	0.9999457288613915	0.4801428050242352	exomes
truth_sample_rank	NA12878	RF	True	1387	48.0	0.9246641508428851	0.9273915584490658	387	383	1	3	18969	18808	2	19566	337	0.9998936735778841	0.49012352113410124	exomes
truth_sample_rank	NA12878	RF	True	1391	49.0	0.9246641508428851	0.9246641508428851	387	386	0	1	19356	19194	2	19180	337	0.9998958116274224	0.5001824151769427	exomes
truth_sample_rank	NA12878	RF	True	1395	50.0	0.9246641508428851	0.9246641508428851	387	385	0	2	19743	19579	2	18795	337	0.9998978601705735	0.5102152499087924	exomes
truth_sample_rank	NA12878	RF	True	1399	51.0	0.9246641508428851	0.9246641508428851	387	384	0	3	20130	19963	2	18411	337	0.9998998246932131	0.5202220253296503	exomes
truth_sample_rank	NA12878	RF	True	1403	52.0	0.9246641508428851	0.9246641508428851	387	386	0	1	20517	20349	2	18025	337	0.9999017247309715	0.5302809193724918	exomes
truth_sample_rank	NA12878	RF	True	1407	53.0	0.9246641508428851	0.9246641508428851	388	381	0	7	20905	20730	2	17644	337	0.9999035307736832	0.5402095168603742	exomes
truth_sample_rank	NA12878	RF	True	1411	54.0	0.9246641508428851	0.9246641508428851	387	376	0	11	21292	21106	2	17268	337	0.9999052491946182	0.5500078177932975	exomes
truth_sample_rank	NA12878	RF	True	1415	55.0	0.9246641508428851	0.9246641508428851	387	384	0	3	21679	21490	2	16884	337	0.9999069421179974	0.5600145932141554	exomes
truth_sample_rank	NA12878	RF	True	1419	56.0	0.9246641508428851	0.9246641508428851	387	384	0	3	22066	21874	2	16500	337	0.9999085756079722	0.5700213686350133	exomes
truth_sample_rank	NA12878	RF	True	1423	57.0	0.9246641508428851	0.9246641508428851	387	381	0	6	22453	22255	2	16119	337	0.9999101406299142	0.5799499661228957	exomes
truth_sample_rank	NA12878	RF	True	1427	58.0	0.9246641508428851	0.9246641508428851	387	376	0	11	22840	22631	2	15743	337	0.9999116334555738	0.5897482670558191	exomes
truth_sample_rank	NA12878	RF	True	1431	59.0	0.9246641508428851	0.9246641508428851	387	382	0	5	23227	23013	2	15361	337	0.9999131001520747	0.5997029238546933	exomes
truth_sample_rank	NA12878	RF	True	1435	60.0	0.9246641508428851	0.9246641508428851	387	383	0	4	23614	23396	2	14978	337	0.99991452260877	0.6096836399645593	exomes
truth_sample_rank	NA12878	RF	True	1439	61.0	0.9246641508428851	0.9246641508428851	388	384	0	4	24002	23780	2	14594	337	0.9999159027836179	0.6196904153854172	exomes
truth_sample_rank	NA12878	RF	True	1443	62.0	0.9246641508428851	0.9246641508428851	387	383	0	4	24389	24163	2	14211	337	0.9999172356714257	0.6296711314952833	exomes
truth_sample_rank	NA12878	RF	True	1447	63.0	0.9246641508428851	0.9246641508428851	387	380	0	7	24776	24543	2	13831	337	0.9999185170095742	0.6395736696721739	exomes
truth_sample_rank	NA12878	RF	True	1451	64.0	0.9241588756130913	0.9246641508428851	387	378	0	9	25163	24921	2	13453	337	0.9999197528387433	0.6494240892270808	exomes
truth_sample_rank	NA12878	RF	True	1455	65.0	0.9240360250036639	0.9241588756130913	387	368	0	19	25550	25289	2	13085	337	0.9999209204855483	0.6590139156720697	exomes
truth_sample_rank	NA12878	RF	True	1459	66.0	0.9240360250036639	0.9240360250036639	387	383	0	4	25937	25672	2	12702	337	0.9999221001791696	0.6689946317819356	exomes
truth_sample_rank	NA12878	RF	True	1463	67.0	0.9240360250036639	0.9240360250036639	387	384	0	3	26324	26056	2	12318	337	0.9999232481387673	0.6790014072027936	exomes
truth_sample_rank	NA12878	RF	True	1467	68.0	0.9240360250036639	0.9240360250036639	387	384	0	3	26711	26440	2	11934	337	0.9999243627562212	0.6890081826236514	exomes
truth_sample_rank	NA12878	RF	True	1471	69.0	0.9240360250036639	0.9240360250036639	388	386	0	2	27099	26826	2	11548	337	0.999925451021321	0.6990670766664929	exomes
truth_sample_rank	NA12878	RF	True	1475	70.0	0.9235307497738701	0.9240360250036639	387	383	0	4	27486	27209	2	11165	337	0.9999265003123736	0.709047792776359	exomes
truth_sample_rank	NA12878	RF	True	1479	71.0	0.9182358727934163	0.9235307497738701	387	379	0	8	27873	27588	2	10786	337	0.9999275099673794	0.7189242716422578	exomes
truth_sample_rank	NA12878	RF	True	1483	72.0	0.9174937404754375	0.9182358727934163	387	379	0	8	28260	27967	2	10407	337	0.999928492259287	0.7288007505081565	exomes
truth_sample_rank	NA12878	RF	True	1487	73.0	0.9174786472818417	0.9174937404754375	387	386	0	1	28647	28353	2	10021	337	0.9999294657026979	0.7388596445509981	exomes
truth_sample_rank	NA12878	RF	True	1491	74.0	0.9169985164742522	0.9174786472818417	387	379	0	8	29034	28732	2	9642	337	0.9999303960464955	0.7487361234168969	exomes
truth_sample_rank	NA12878	RF	True	1495	75.0	0.9169985164742522	0.9169985164742522	387	384	0	3	29421	29116	2	9258	337	0.9999313139638711	0.7587428988377547	exomes
truth_sample_rank	NA12878	RF	True	1499	76.0	0.9159183442800394	0.9169985164742522	388	383	0	5	29809	29499	2	8875	337	0.9999322056879428	0.7687236149476208	exomes
truth_sample_rank	NA12878	RF	True	1503	77.0	0.9159012396730493	0.9159183442800394	387	384	0	3	30196	29883	2	8491	337	0.9999330767943785	0.7787303903684787	exomes
truth_sample_rank	NA12878	RF	True	1507	78.0	0.9113332661569825	0.9159012396730493	387	328	0	59	30583	30211	2	8163	337	0.9999338033296925	0.7872778443737948	exomes
truth_sample_rank	NA12878	RF	True	1511	79.0	0.9089021417772568	0.9113332661569825	387	337	0	50	30970	30548	2	7826	337	0.9999345335515548	0.7960598321780372	exomes
truth_sample_rank	NA12878	RF	True	1515	80.0	0.905169723556892	0.9089021417772568	387	306	0	81	31357	30854	2	7520	337	0.9999351827845476	0.8040339813415334	exomes
truth_sample_rank	NA12878	RF	True	1519	81.0	0.9041223952732327	0.905169723556892	387	385	0	2	31744	31239	2	7135	337	0.99993598156269	0.814066816073383	exomes
truth_sample_rank	NA12878	RF	True	1523	82.0	0.9033802629552538	0.9041223952732327	387	385	0	2	32131	31624	2	6750	337	0.9999367608929361	0.8240996508052327	exomes
truth_sample_rank	NA12878	RF	True	1527	83.0	0.9026250463371421	0.9033802629552538	387	382	2	3	32518	32006	4	6368	335	0.9998750390502967	0.8340543076041069	exomes
truth_sample_rank	NA12878	RF	True	1531	84.0	0.9015825539168679	0.9026250463371421	388	372	0	16	32906	32378	4	5996	335	0.9998764745846458	0.843748371293063	exomes
truth_sample_rank	NA12878	RF	True	1535	85.0	0.8991045988740547	0.9015825539168679	387	379	0	8	33293	32757	4	5617	335	0.999877903604896	0.8536248501589618	exomes
truth_sample_rank	NA12878	RF	True	1539	86.0	0.887216029835433	0.8990848876552612	387	358	0	29	33680	33115	4	5259	335	0.9998792234065038	0.8629540834940325	exomes
truth_sample_rank	NA12878	RF	True	1543	87.0	0.8827354668774767	0.887216029835433	387	373	0	14	34067	33488	4	4886	335	0.9998805684939687	0.8726742064939803	exomes
truth_sample_rank	NA12878	RF	True	1547	88.0	0.8712745905291881	0.8827354668774767	387	374	0	13	34454	33862	4	4512	335	0.9998818874387291	0.88242038880492	exomes
truth_sample_rank	NA12878	RF	True	1551	89.0	0.8660946727669779	0.8712745905291881	387	378	0	9	34841	34240	4	4134	335	0.9998831912159795	0.892270808359827	exomes
truth_sample_rank	NA12878	RF	True	1555	90.0	0.862677290772579	0.8660508900048735	387	383	0	4	35228	34623	4	3751	335	0.9998844832067462	0.902251524469693	exomes
truth_sample_rank	NA12878	RF	True	1559	91.0	0.8570795451532357	0.8626728925484992	387	380	0	7	35615	35003	4	3371	335	0.9998857371382867	0.9121540626465836	exomes
truth_sample_rank	NA12878	RF	True	1563	92.0	0.8515999389782474	0.8570795451532357	388	377	0	11	36003	35380	4	2994	335	0.9998869545557314	0.9219784228904988	exomes
truth_sample_rank	NA12878	RF	True	1567	93.0	0.8402075650714541	0.8515515515002104	387	372	0	15	36390	35752	4	2622	335	0.9998881306633851	0.9316724865794548	exomes
truth_sample_rank	NA12878	RF	True	1571	94.0	0.8277333933161426	0.8401808822648148	387	368	2	17	36777	36120	6	2254	333	0.9998339146321209	0.9412623130244436	exomes
truth_sample_rank	NA12878	RF	True	1575	95.0	0.8139256684274759	0.8276903140343385	387	338	2	47	37164	36458	8	1916	331	0.9997806175615642	0.9500703601396779	exomes
truth_sample_rank	NA12878	RF	True	1579	96.0	0.7901762562752167	0.8138299127612673	387	339	2	46	37551	36797	10	1577	329	0.9997283125492433	0.958904466565904	exomes
truth_sample_rank	NA12878	RF	True	1583	97.0	0.6096500305085591	0.7901011432769841	387	347	8	32	37938	37144	18	1230	321	0.9995156342500404	0.9679470474800647	exomes
truth_sample_rank	NA12878	RF	True	1587	98.0	0.35967952809043807	0.6096500305085591	387	263	21	103	38325	37407	39	967	300	0.998958500240346	0.9748006462709126	exomes
truth_sample_rank	NA12878	RF	True	1591	99.0	0.009049676032541273	0.3585455393267718	387	48	300	39	38712	37455	339	919	0	0.9910303222733767	0.9760514931985198	exomes
truth_sample_rank	NA12878	RF	True	1595	100.0	-1.0	-1.0	1	0	0	1	38713	37455	339	919	0	0.9910303222733767	0.9760514931985198	exomes
truth_sample_rank	NA12878	VQSR	False	792	0.0	7.57	7.64	28	27	1	0	28	27	1	2407	414	0.9642857142857143	0.011092851273623664	exomes
truth_sample_rank	NA12878	VQSR	False	796	1.0	7.5	7.56	28	28	0	0	56	55	1	2379	414	0.9821428571428571	0.02259654889071487	exomes
truth_sample_rank	NA12878	VQSR	False	800	2.0	7.45	7.5	29	29	0	0	85	84	1	2350	414	0.9882352941176471	0.03451109285127362	exomes
truth_sample_rank	NA12878	VQSR	False	804	3.0	7.4	7.45	28	26	1	1	113	110	2	2324	413	0.9821428571428571	0.04519309778142974	exomes
truth_sample_rank	NA12878	VQSR	False	808	4.0	7.35	7.4	29	28	1	0	142	138	3	2296	412	0.9787234042553191	0.056696795398520954	exomes
truth_sample_rank	NA12878	VQSR	False	812	5.0	7.3	7.34	28	28	0	0	170	166	3	2268	412	0.9822485207100592	0.06820049301561217	exomes
truth_sample_rank	NA12878	VQSR	False	816	6.0	7.26	7.3	29	28	0	1	199	194	3	2240	412	0.9847715736040609	0.07970419063270337	exomes
truth_sample_rank	NA12878	VQSR	False	820	7.0	7.23	7.26	28	26	1	1	227	220	4	2214	411	0.9821428571428571	0.09038619556285948	exomes
truth_sample_rank	NA12878	VQSR	False	824	8.0	7.2	7.23	29	26	1	2	256	246	5	2188	410	0.9800796812749004	0.10106820049301561	exomes
truth_sample_rank	NA12878	VQSR	False	828	9.0	7.16	7.19	28	27	1	0	284	273	6	2161	409	0.978494623655914	0.11216105176663928	exomes
truth_sample_rank	NA12878	VQSR	False	832	10.0	7.11	7.16	29	29	0	0	313	302	6	2132	409	0.9805194805194806	0.12407559572719803	exomes
truth_sample_rank	NA12878	VQSR	False	836	11.0	7.08	7.11	28	28	0	0	341	330	6	2104	409	0.9821428571428571	0.13557929334428923	exomes
truth_sample_rank	NA12878	VQSR	False	840	12.0	7.03	7.07	29	28	1	0	370	358	7	2076	408	0.9808219178082191	0.14708299096138044	exomes
truth_sample_rank	NA12878	VQSR	False	844	13.0	6.97	7.03	28	26	0	2	398	384	7	2050	408	0.9820971867007673	0.15776499589153656	exomes
truth_sample_rank	NA12878	VQSR	False	848	14.0	6.91	6.97	29	29	0	0	427	413	7	2021	408	0.9833333333333333	0.16967953985209533	exomes
truth_sample_rank	NA12878	VQSR	False	852	15.0	6.85	6.91	28	27	0	1	455	440	7	1994	408	0.9843400447427293	0.18077239112571897	exomes
truth_sample_rank	NA12878	VQSR	False	856	16.0	6.79	6.85	29	28	0	1	484	468	7	1966	408	0.9852631578947368	0.1922760887428102	exomes
truth_sample_rank	NA12878	VQSR	False	860	17.0	6.74	6.79	28	28	0	0	512	496	7	1938	408	0.9860834990059643	0.2037797863599014	exomes
truth_sample_rank	NA12878	VQSR	False	864	18.0	6.67	6.74	29	28	0	1	541	524	7	1910	408	0.9868173258003766	0.2152834839769926	exomes
truth_sample_rank	NA12878	VQSR	False	868	19.0	6.6	6.67	28	26	1	1	569	550	8	1884	407	0.985663082437276	0.22596548890714874	exomes
truth_sample_rank	NA12878	VQSR	False	872	20.0	6.49	6.58	29	28	0	1	598	578	8	1856	407	0.9863481228668942	0.23746918652423993	exomes
truth_sample_rank	NA12878	VQSR	False	876	21.0	6.4	6.48	28	28	0	0	626	606	8	1828	407	0.9869706840390879	0.24897288414133115	exomes
truth_sample_rank	NA12878	VQSR	False	880	22.0	6.29	6.4	29	27	2	0	655	633	10	1801	405	0.9844479004665629	0.2600657354149548	exomes
truth_sample_rank	NA12878	VQSR	False	884	23.0	6.22	6.29	28	28	0	0	683	661	10	1773	405	0.9850968703427719	0.271569433032046	exomes
truth_sample_rank	NA12878	VQSR	False	888	24.0	6.14	6.21	29	27	1	1	712	688	11	1746	404	0.9842632331902719	0.2826622843056697	exomes
truth_sample_rank	NA12878	VQSR	False	892	25.0	6.06	6.13	28	27	1	0	740	715	12	1719	403	0.9834938101788171	0.29375513557929334	exomes
truth_sample_rank	NA12878	VQSR	False	896	26.0	5.98	6.06	29	25	2	2	769	740	14	1694	401	0.9814323607427056	0.3040262941659819	exomes
truth_sample_rank	NA12878	VQSR	False	900	27.0	5.9	5.98	28	27	0	1	797	767	14	1667	401	0.9820742637644047	0.31511914543960556	exomes
truth_sample_rank	NA12878	VQSR	False	904	28.0	5.85	5.9	29	28	1	0	826	795	15	1639	400	0.9814814814814815	0.3266228430566968	exomes
truth_sample_rank	NA12878	VQSR	False	908	29.0	5.81	5.85	28	26	1	1	854	821	16	1613	399	0.980884109916368	0.3373048479868529	exomes
truth_sample_rank	NA12878	VQSR	False	912	30.0	5.75	5.81	29	27	1	1	883	848	17	1586	398	0.9803468208092485	0.3483976992604766	exomes
truth_sample_rank	NA12878	VQSR	False	916	31.0	5.7	5.75	28	27	0	1	911	875	17	1559	398	0.9809417040358744	0.35949055053410023	exomes
truth_sample_rank	NA12878	VQSR	False	920	32.0	5.63	5.69	29	26	2	1	940	901	19	1533	396	0.9793478260869565	0.37017255546425637	exomes
truth_sample_rank	NA12878	VQSR	False	924	33.0	5.54	5.62	28	26	1	1	968	927	20	1507	395	0.9788806758183738	0.3808545603944125	exomes
truth_sample_rank	NA12878	VQSR	False	928	34.0	5.45	5.54	29	27	1	1	997	954	21	1480	394	0.9784615384615385	0.39194741166803615	exomes
truth_sample_rank	NA12878	VQSR	False	932	35.0	5.39	5.44	28	27	1	0	1025	981	22	1453	393	0.9780658025922233	0.40304026294165984	exomes
truth_sample_rank	NA12878	VQSR	False	936	36.0	5.32	5.38	29	28	1	0	1054	1009	23	1425	392	0.9777131782945736	0.41454396055875103	exomes
truth_sample_rank	NA12878	VQSR	False	940	37.0	5.22	5.32	28	27	1	0	1082	1036	24	1398	391	0.9773584905660377	0.4256368118323747	exomes
truth_sample_rank	NA12878	VQSR	False	944	38.0	5.14	5.22	29	27	2	0	1111	1063	26	1371	389	0.9761248852157943	0.43672966310599837	exomes
truth_sample_rank	NA12878	VQSR	False	948	39.0	5.04	5.13	28	26	0	2	1139	1089	26	1345	389	0.9766816143497757	0.44741166803615445	exomes
truth_sample_rank	NA12878	VQSR	False	952	40.0	4.9	5.03	29	26	3	0	1168	1115	29	1319	386	0.9746503496503497	0.4580936729663106	exomes
truth_sample_rank	NA12878	VQSR	False	956	41.0	4.8	4.9	28	26	2	0	1196	1141	31	1293	384	0.9735494880546075	0.46877567789646674	exomes
truth_sample_rank	NA12878	VQSR	False	960	42.0	4.67	4.8	29	23	5	1	1225	1164	36	1270	379	0.97	0.4782251437962202	exomes
truth_sample_rank	NA12878	VQSR	False	964	43.0	4.56	4.66	28	28	0	0	1253	1192	36	1242	379	0.9706840390879479	0.4897288414133114	exomes
truth_sample_rank	NA12878	VQSR	False	968	44.0	4.43	4.56	29	27	2	0	1282	1219	38	1215	377	0.9697692919649961	0.5008216926869351	exomes
truth_sample_rank	NA12878	VQSR	False	972	45.0	4.37	4.43	28	23	4	1	1310	1242	42	1192	373	0.9672897196261683	0.5102711585866886	exomes
truth_sample_rank	NA12878	VQSR	False	976	46.0	4.31	4.37	29	27	2	0	1339	1269	44	1165	371	0.9664889565879665	0.5213640098603123	exomes
truth_sample_rank	NA12878	VQSR	False	980	47.0	4.27	4.31	28	25	2	1	1367	1294	46	1140	369	0.9656716417910448	0.5316351684470009	exomes
truth_sample_rank	NA12878	VQSR	False	984	48.0	4.19	4.27	29	27	2	0	1396	1321	48	1113	367	0.9649379108838568	0.5427280197206245	exomes
truth_sample_rank	NA12878	VQSR	False	988	49.0	4.15	4.19	28	23	2	3	1424	1344	50	1090	365	0.9641319942611191	0.5521774856203779	exomes
truth_sample_rank	NA12878	VQSR	False	992	50.0	4.08	4.14	28	24	1	3	1452	1368	51	1066	364	0.9640591966173362	0.562037797863599	exomes
truth_sample_rank	NA12878	VQSR	False	996	51.0	4.03	4.07	29	27	1	1	1481	1395	52	1039	363	0.9640635798203179	0.5731306491372227	exomes
truth_sample_rank	NA12878	VQSR	False	1000	52.0	3.95	4.03	28	25	2	1	1509	1420	54	1014	361	0.9633649932157394	0.5834018077239113	exomes
truth_sample_rank	NA12878	VQSR	False	1004	53.0	3.85	3.94	29	23	2	4	1538	1443	56	991	359	0.962641761174116	0.5928512736236647	exomes
truth_sample_rank	NA12878	VQSR	False	1008	54.0	3.79	3.85	28	24	2	2	1566	1467	58	967	357	0.9619672131147541	0.6027115858668858	exomes
truth_sample_rank	NA12878	VQSR	False	1012	55.0	3.7	3.79	29	24	2	3	1595	1491	60	943	355	0.9613152804642167	0.6125718981101068	exomes
truth_sample_rank	NA12878	VQSR	False	1016	56.0	3.62	3.7	28	22	4	2	1623	1513	64	921	351	0.9594166138237159	0.6216105176663927	exomes
truth_sample_rank	NA12878	VQSR	False	1020	57.0	3.54	3.62	29	22	4	3	1652	1535	68	899	347	0.9575795383655645	0.6306491372226787	exomes
truth_sample_rank	NA12878	VQSR	False	1024	58.0	3.44	3.54	28	20	6	2	1680	1555	74	879	341	0.954573357888275	0.6388660640920296	exomes
truth_sample_rank	NA12878	VQSR	False	1028	59.0	3.37	3.44	29	19	9	1	1709	1574	83	860	332	0.9499094749547374	0.6466721446179129	exomes
truth_sample_rank	NA12878	VQSR	False	1032	60.0	3.3	3.37	28	12	13	3	1737	1586	96	848	319	0.9429250891795482	0.6516023007395234	exomes
truth_sample_rank	NA12878	VQSR	False	1036	61.0	3.25	3.3	29	16	11	2	1766	1602	107	832	308	0.9373902867173786	0.6581758422350041	exomes
truth_sample_rank	NA12878	VQSR	False	1040	62.0	3.19	3.25	28	15	13	0	1794	1617	120	817	295	0.9309153713298791	0.6643385373870172	exomes
truth_sample_rank	NA12878	VQSR	False	1044	63.0	3.14	3.19	29	19	10	0	1823	1636	130	798	285	0.9263873159682899	0.6721446179129006	exomes
truth_sample_rank	NA12878	VQSR	False	1048	64.0	3.08	3.14	28	17	11	0	1851	1653	141	781	274	0.9214046822742475	0.6791290057518488	exomes
truth_sample_rank	NA12878	VQSR	False	1052	65.0	3.02	3.08	29	15	12	2	1880	1668	153	766	262	0.9159802306425041	0.6852917009038619	exomes
truth_sample_rank	NA12878	VQSR	False	1056	66.0	2.96	3.02	28	18	10	0	1908	1686	163	748	252	0.9118442401297999	0.6926869350862778	exomes
truth_sample_rank	NA12878	VQSR	False	1060	67.0	2.9	2.96	29	14	12	3	1937	1700	175	734	240	0.9066666666666666	0.6984387838948234	exomes
truth_sample_rank	NA12878	VQSR	False	1064	68.0	2.84	2.9	28	21	7	0	1965	1721	182	713	233	0.9043615344193379	0.7070665571076418	exomes
truth_sample_rank	NA12878	VQSR	False	1068	69.0	2.76	2.83	29	15	9	5	1994	1736	191	698	224	0.9008822003113648	0.7132292522596549	exomes
truth_sample_rank	NA12878	VQSR	False	1072	70.0	2.69	2.76	28	18	8	2	2022	1754	199	680	216	0.8981054787506401	0.7206244864420707	exomes
truth_sample_rank	NA12878	VQSR	False	1076	71.0	2.6	2.69	29	22	5	2	2051	1776	204	658	211	0.896969696969697	0.7296631059983566	exomes
truth_sample_rank	NA12878	VQSR	False	1080	72.0	2.51	2.59	28	16	10	2	2079	1792	214	642	201	0.8933200398803589	0.7362366474938373	exomes
truth_sample_rank	NA12878	VQSR	False	1084	73.0	2.37	2.51	29	20	5	4	2108	1812	219	622	196	0.8921713441654358	0.7444535743631882	exomes
truth_sample_rank	NA12878	VQSR	False	1088	74.0	2.23	2.37	28	18	6	4	2136	1830	225	604	190	0.8905109489051095	0.751848808545604	exomes
truth_sample_rank	NA12878	VQSR	False	1092	75.0	2.13	2.23	29	19	5	5	2165	1849	230	585	185	0.8893698893698894	0.7596548890714873	exomes
truth_sample_rank	NA12878	VQSR	False	1096	76.0	2.04	2.13	28	22	3	3	2193	1871	233	563	182	0.8892585551330798	0.7686935086277732	exomes
truth_sample_rank	NA12878	VQSR	False	1100	77.0	1.93	2.04	29	16	5	8	2222	1887	238	547	177	0.888	0.7752670501232539	exomes
truth_sample_rank	NA12878	VQSR	False	1104	78.0	1.81	1.93	28	24	2	2	2250	1911	240	523	175	0.8884239888423989	0.785127362366475	exomes
truth_sample_rank	NA12878	VQSR	False	1108	79.0	1.67	1.81	29	21	4	4	2279	1932	244	502	171	0.8878676470588235	0.7937551355792933	exomes
truth_sample_rank	NA12878	VQSR	False	1112	80.0	1.54	1.66	28	21	6	1	2307	1953	250	481	165	0.8865183840217885	0.8023829087921117	exomes
truth_sample_rank	NA12878	VQSR	False	1116	81.0	1.42	1.53	29	26	0	3	2336	1979	250	455	165	0.8878420816509646	0.8130649137222679	exomes
truth_sample_rank	NA12878	VQSR	False	1120	82.0	1.36	1.42	28	23	3	2	2364	2002	253	432	162	0.8878048780487805	0.8225143796220213	exomes
truth_sample_rank	NA12878	VQSR	False	1124	83.0	1.31	1.35	29	23	5	1	2393	2025	258	409	157	0.8869908015768725	0.8319638455217748	exomes
truth_sample_rank	NA12878	VQSR	False	1128	84.0	1.24	1.31	28	20	5	3	2421	2045	263	389	152	0.8860485268630849	0.8401807723911258	exomes
truth_sample_rank	NA12878	VQSR	False	1132	85.0	1.17	1.24	29	24	3	2	2450	2069	266	365	149	0.8860813704496788	0.8500410846343468	exomes
truth_sample_rank	NA12878	VQSR	False	1136	86.0	1.11	1.17	28	14	12	2	2478	2083	278	351	137	0.8822532825074121	0.8557929334428923	exomes
truth_sample_rank	NA12878	VQSR	False	1140	87.0	1.04	1.1	29	9	18	2	2507	2092	296	342	119	0.8760469011725294	0.8594905505341003	exomes
truth_sample_rank	NA12878	VQSR	False	1144	88.0	0.944	1.03	28	11	14	3	2535	2103	310	331	105	0.871529216742644	0.8640098603122432	exomes
truth_sample_rank	NA12878	VQSR	False	1148	89.0	0.753	0.925	29	14	12	3	2564	2117	322	317	93	0.8679786797867979	0.8697617091207889	exomes
truth_sample_rank	NA12878	VQSR	False	1152	90.0	0.427	0.745	28	16	9	3	2592	2133	331	301	84	0.8656655844155844	0.8763352506162695	exomes
truth_sample_rank	NA12878	VQSR	False	1156	91.0	0.101	0.402	29	16	11	2	2621	2149	342	285	73	0.862705740666399	0.8829087921117502	exomes
truth_sample_rank	NA12878	VQSR	False	1160	92.0	-0.2333	0.072	28	13	7	8	2649	2162	349	272	66	0.8610115491835922	0.8882497945768283	exomes
truth_sample_rank	NA12878	VQSR	False	1164	93.0	-0.6781	-0.2446	29	10	4	15	2678	2172	353	262	62	0.8601980198019802	0.8923582580115037	exomes
truth_sample_rank	NA12878	VQSR	False	1168	94.0	-11.52	-0.7611	28	9	18	1	2706	2181	371	253	44	0.8546238244514106	0.8960558751027116	exomes
truth_sample_rank	NA12878	VQSR	False	1172	95.0	-159.9	-11.88	29	0	29	0	2735	2181	400	253	15	0.8450213095699342	0.8960558751027116	exomes
truth_sample_rank	NA12878	VQSR	False	1176	96.0	-185.5	-166.0	28	2	6	20	2763	2183	406	251	9	0.84318269602163	0.8968775677896467	exomes
truth_sample_rank	NA12878	VQSR	False	1180	97.0	-1.0	-1.0	29	1	4	24	2792	2184	410	250	5	0.8419429452582884	0.8972884141331142	exomes
truth_sample_rank	NA12878	VQSR	False	1184	98.0	-1.0	-1.0	28	4	2	22	2820	2188	412	246	3	0.8415384615384616	0.8989317995069844	exomes
truth_sample_rank	NA12878	VQSR	False	1188	99.0	-1.0	-1.0	28	0	3	25	2848	2188	415	246	0	0.8405685747214752	0.8989317995069844	exomes
truth_sample_rank	NA12878	VQSR	False	1192	100.0	-1.0	-1.0	1	0	0	1	2849	2188	415	246	0	0.8405685747214752	0.8989317995069844	exomes
truth_sample_rank	NA12878	VQSR	True	1196	0.0	8.18	9.0	387	387	0	0	387	387	0	37987	339	1.0	0.010084953353833324	exomes
truth_sample_rank	NA12878	VQSR	True	1200	1.0	7.95	8.18	387	387	0	0	774	774	0	37600	339	1.0	0.02016990670766665	exomes
truth_sample_rank	NA12878	VQSR	True	1204	2.0	7.8	7.95	387	387	0	0	1161	1161	0	37213	339	1.0	0.030254860061499973	exomes
truth_sample_rank	NA12878	VQSR	True	1208	3.0	7.66	7.8	387	387	0	0	1548	1548	0	36826	339	1.0	0.0403398134153333	exomes
truth_sample_rank	NA12878	VQSR	True	1212	4.0	7.53	7.66	387	387	0	0	1935	1935	0	36439	339	1.0	0.05042476676916662	exomes
truth_sample_rank	NA12878	VQSR	True	1216	5.0	7.42	7.53	387	387	0	0	2322	2322	0	36052	339	1.0	0.060509720122999947	exomes
truth_sample_rank	NA12878	VQSR	True	1220	6.0	7.31	7.42	387	386	0	1	2709	2708	0	35666	339	1.0	0.07056861416584145	exomes
truth_sample_rank	NA12878	VQSR	True	1224	7.0	7.22	7.31	388	388	0	0	3097	3096	0	35278	339	1.0	0.0806796268306666	exomes
truth_sample_rank	NA12878	VQSR	True	1228	8.0	7.14	7.22	387	387	0	0	3484	3483	0	34891	339	1.0	0.09076458018449993	exomes
truth_sample_rank	NA12878	VQSR	True	1232	9.0	7.06	7.14	387	387	0	0	3871	3870	0	34504	339	1.0	0.10084953353833324	exomes
truth_sample_rank	NA12878	VQSR	True	1236	10.0	6.98	7.06	387	387	0	0	4258	4257	0	34117	339	1.0	0.11093448689216658	exomes
truth_sample_rank	NA12878	VQSR	True	1240	11.0	6.9	6.98	387	386	0	1	4645	4643	0	33731	339	1.0	0.12099338093500808	exomes
truth_sample_rank	NA12878	VQSR	True	1244	12.0	6.83	6.9	387	387	0	0	5032	5030	0	33344	339	1.0	0.1310783342888414	exomes
truth_sample_rank	NA12878	VQSR	True	1248	13.0	6.77	6.83	387	387	0	0	5419	5417	0	32957	339	1.0	0.14116328764267472	exomes
truth_sample_rank	NA12878	VQSR	True	1252	14.0	6.72	6.77	387	387	0	0	5806	5804	0	32570	339	1.0	0.15124824099650805	exomes
truth_sample_rank	NA12878	VQSR	True	1256	15.0	6.66	6.72	388	388	0	0	6194	6192	0	32182	339	1.0	0.1613592536613332	exomes
truth_sample_rank	NA12878	VQSR	True	1260	16.0	6.61	6.66	387	386	0	1	6581	6578	0	31796	339	1.0	0.1714181477041747	exomes
truth_sample_rank	NA12878	VQSR	True	1264	17.0	6.57	6.61	387	387	0	0	6968	6965	0	31409	339	1.0	0.18150310105800802	exomes
truth_sample_rank	NA12878	VQSR	True	1268	18.0	6.52	6.57	387	387	0	0	7355	7352	0	31022	339	1.0	0.19158805441184135	exomes
truth_sample_rank	NA12878	VQSR	True	1272	19.0	6.48	6.52	387	385	0	2	7742	7737	0	30637	339	1.0	0.20162088914369103	exomes
truth_sample_rank	NA12878	VQSR	True	1276	20.0	6.43	6.48	387	385	0	2	8129	8122	0	30252	339	1.0	0.21165372387554074	exomes
truth_sample_rank	NA12878	VQSR	True	1280	21.0	6.39	6.43	387	386	0	1	8516	8508	0	29866	339	1.0	0.22171261791838223	exomes
truth_sample_rank	NA12878	VQSR	True	1284	22.0	6.35	6.39	387	386	0	1	8903	8894	0	29480	339	1.0	0.23177151196122375	exomes
truth_sample_rank	NA12878	VQSR	True	1288	23.0	6.31	6.35	388	388	0	0	9291	9282	0	29092	339	1.0	0.2418825246260489	exomes
truth_sample_rank	NA12878	VQSR	True	1292	24.0	6.27	6.31	387	387	0	0	9678	9669	0	28705	339	1.0	0.2519674779798822	exomes
truth_sample_rank	NA12878	VQSR	True	1296	25.0	6.24	6.27	387	384	0	3	10065	10053	0	28321	339	1.0	0.2619742534007401	exomes
truth_sample_rank	NA12878	VQSR	True	1300	26.0	6.21	6.24	387	386	1	0	10452	10439	1	27935	338	0.9999042145593869	0.2720331474435816	exomes
truth_sample_rank	NA12878	VQSR	True	1304	27.0	6.18	6.21	387	385	0	2	10839	10824	1	27550	338	0.9999076212471132	0.2820659821754313	exomes
truth_sample_rank	NA12878	VQSR	True	1308	28.0	6.15	6.18	387	387	0	0	11226	11211	1	27163	338	0.999910809846593	0.29215093552926463	exomes
truth_sample_rank	NA12878	VQSR	True	1312	29.0	6.11	6.15	387	386	0	1	11613	11597	1	26777	338	0.9999137782376272	0.3022098295721061	exomes
truth_sample_rank	NA12878	VQSR	True	1316	30.0	6.08	6.11	388	388	0	0	12001	11985	1	26389	338	0.999916569330886	0.31232084223693124	exomes
truth_sample_rank	NA12878	VQSR	True	1320	31.0	6.06	6.08	387	387	0	0	12388	12372	1	26002	338	0.9999191788571891	0.3224057955907646	exomes
truth_sample_rank	NA12878	VQSR	True	1324	32.0	6.03	6.06	387	387	0	0	12775	12759	1	25615	338	0.9999216300940439	0.3324907489445979	exomes
truth_sample_rank	NA12878	VQSR	True	1328	33.0	6.0	6.03	387	386	0	1	13162	13145	1	25229	338	0.9999239312338354	0.3425496429874394	exomes
truth_sample_rank	NA12878	VQSR	True	1332	34.0	5.97	6.0	387	387	0	0	13549	13532	1	24842	338	0.9999261065543487	0.35263459634127275	exomes
truth_sample_rank	NA12878	VQSR	True	1336	35.0	5.95	5.97	387	386	0	1	13936	13918	1	24456	338	0.999928155758316	0.36269349038411425	exomes
truth_sample_rank	NA12878	VQSR	True	1340	36.0	5.92	5.95	387	387	0	0	14323	14305	1	24069	338	0.9999300992590522	0.37277844373794755	exomes
truth_sample_rank	NA12878	VQSR	True	1344	37.0	5.9	5.92	387	387	0	0	14710	14692	1	23682	338	0.9999319403797727	0.3828633970917809	exomes
truth_sample_rank	NA12878	VQSR	True	1348	38.0	5.87	5.9	388	387	0	1	15098	15079	1	23295	338	0.9999336870026525	0.3929483504456142	exomes
truth_sample_rank	NA12878	VQSR	True	1352	39.0	5.85	5.87	387	384	0	3	15485	15463	1	22911	338	0.9999353336782204	0.4029551258664721	exomes
truth_sample_rank	NA12878	VQSR	True	1356	40.0	5.82	5.85	387	387	0	0	15872	15850	1	22524	338	0.9999369124976342	0.4130400792203054	exomes
truth_sample_rank	NA12878	VQSR	True	1360	41.0	5.79	5.82	387	386	0	1	16259	16236	1	22138	338	0.9999384122682762	0.42309897326314694	exomes
truth_sample_rank	NA12878	VQSR	True	1364	42.0	5.77	5.79	387	386	0	1	16646	16622	1	21752	338	0.9999398423870541	0.43315786730598843	exomes
truth_sample_rank	NA12878	VQSR	True	1368	43.0	5.74	5.77	387	386	0	1	17033	17008	1	21366	338	0.9999412075959786	0.4432167613488299	exomes
truth_sample_rank	NA12878	VQSR	True	1372	44.0	5.72	5.74	387	386	0	1	17420	17394	1	20980	338	0.999942512216154	0.4532756553916714	exomes
truth_sample_rank	NA12878	VQSR	True	1376	45.0	5.69	5.72	387	384	0	3	17807	17778	1	20596	338	0.9999437538669217	0.46328243081252934	exomes
truth_sample_rank	NA12878	VQSR	True	1380	46.0	5.66	5.69	388	388	0	0	18195	18166	1	20208	338	0.9999449551384378	0.47339344347735446	exomes
truth_sample_rank	NA12878	VQSR	True	1384	47.0	5.63	5.66	387	386	1	0	18582	18552	2	19822	337	0.9998922065322842	0.48345233752019595	exomes
truth_sample_rank	NA12878	VQSR	True	1388	48.0	5.6	5.63	387	386	0	1	18969	18938	2	19436	337	0.9998944033790919	0.4935112315630375	exomes
truth_sample_rank	NA12878	VQSR	True	1392	49.0	5.57	5.6	387	385	0	2	19356	19323	2	19051	337	0.9998965071151358	0.5035440662948871	exomes
truth_sample_rank	NA12878	VQSR	True	1396	50.0	5.54	5.57	387	387	0	0	19743	19710	2	18664	337	0.999898538961039	0.5136290196487205	exomes
truth_sample_rank	NA12878	VQSR	True	1400	51.0	5.5	5.54	387	384	0	3	20130	20094	2	18280	337	0.9999004777070064	0.5236357950695784	exomes
truth_sample_rank	NA12878	VQSR	True	1404	52.0	5.47	5.5	387	386	0	1	20517	20480	2	17894	337	0.9999023532858119	0.5336946891124199	exomes
truth_sample_rank	NA12878	VQSR	True	1408	53.0	5.44	5.47	388	387	0	1	20905	20867	2	17507	337	0.9999041640711103	0.5437796424662532	exomes
truth_sample_rank	NA12878	VQSR	True	1412	54.0	5.4	5.44	387	385	1	1	21292	21252	3	17122	336	0.9998588567395907	0.5538124771981029	exomes
truth_sample_rank	NA12878	VQSR	True	1416	55.0	5.36	5.4	387	381	0	6	21679	21633	3	16741	336	0.9998613422074321	0.5637410746859853	exomes
truth_sample_rank	NA12878	VQSR	True	1420	56.0	5.33	5.36	387	386	1	0	22066	22019	4	16355	335	0.9998183717023112	0.5737999687288268	exomes
truth_sample_rank	NA12878	VQSR	True	1424	57.0	5.29	5.33	387	383	0	4	22453	22402	4	15972	335	0.9998214763902527	0.5837806848386928	exomes
truth_sample_rank	NA12878	VQSR	True	1428	58.0	5.25	5.29	387	385	0	2	22840	22787	4	15587	335	0.9998244921240841	0.5938135195705425	exomes
truth_sample_rank	NA12878	VQSR	True	1432	59.0	5.22	5.25	387	385	0	2	23227	23172	4	15202	335	0.9998274076630997	0.6038463543023922	exomes
truth_sample_rank	NA12878	VQSR	True	1436	60.0	5.18	5.22	387	387	0	0	23614	23559	4	14815	335	0.9998302423290752	0.6139313076562256	exomes
truth_sample_rank	NA12878	VQSR	True	1440	61.0	5.13	5.18	388	383	0	5	24002	23942	4	14432	335	0.9998329574876806	0.6239120237660917	exomes
truth_sample_rank	NA12878	VQSR	True	1444	62.0	5.09	5.13	387	385	0	2	24389	24327	4	14047	335	0.9998356006740372	0.6339448584979414	exomes
truth_sample_rank	NA12878	VQSR	True	1448	63.0	5.04	5.09	387	385	0	2	24776	24712	4	13662	335	0.9998381615148082	0.643977693229791	exomes
truth_sample_rank	NA12878	VQSR	True	1452	64.0	4.99	5.04	387	384	0	3	25163	25096	4	13278	335	0.9998406374501992	0.6539844686506489	exomes
truth_sample_rank	NA12878	VQSR	True	1456	65.0	4.94	4.99	387	383	0	4	25550	25479	4	12895	335	0.9998430326099753	0.6639651847605149	exomes
truth_sample_rank	NA12878	VQSR	True	1460	66.0	4.88	4.94	387	384	0	3	25937	25863	4	12511	335	0.9998453628174895	0.6739719601813728	exomes
truth_sample_rank	NA12878	VQSR	True	1464	67.0	4.83	4.88	387	380	0	7	26324	26243	4	12131	335	0.9998476016306626	0.6838744983582634	exomes
truth_sample_rank	NA12878	VQSR	True	1468	68.0	4.76	4.83	387	383	0	4	26711	26626	4	11748	335	0.9998497934660158	0.6938552144681295	exomes
truth_sample_rank	NA12878	VQSR	True	1472	69.0	4.7	4.76	388	387	0	1	27099	27013	4	11361	335	0.9998519450716216	0.7039401678219628	exomes
truth_sample_rank	NA12878	VQSR	True	1476	70.0	4.63	4.7	387	381	0	6	27486	27394	4	10980	335	0.9998540039418936	0.7138687653098452	exomes
truth_sample_rank	NA12878	VQSR	True	1480	71.0	4.56	4.63	387	386	0	1	27873	27780	4	10594	335	0.9998560322487763	0.7239276593526868	exomes
truth_sample_rank	NA12878	VQSR	True	1484	72.0	4.48	4.56	387	381	0	6	28260	28161	4	10213	335	0.9998579797621161	0.7338562568405691	exomes
truth_sample_rank	NA12878	VQSR	True	1488	73.0	4.41	4.48	387	373	0	14	28647	28534	4	9840	335	0.9998598360081296	0.743576379840517	exomes
truth_sample_rank	NA12878	VQSR	True	1492	74.0	4.32	4.41	387	383	0	4	29034	28917	4	9457	335	0.9998616921959822	0.7535570959503831	exomes
truth_sample_rank	NA12878	VQSR	True	1496	75.0	4.23	4.32	387	380	0	7	29421	29297	4	9077	335	0.9998634858878537	0.7634596341272737	exomes
truth_sample_rank	NA12878	VQSR	True	1500	76.0	4.14	4.23	388	384	0	4	29809	29681	4	8693	335	0.9998652518106788	0.7734664095481315	exomes
truth_sample_rank	NA12878	VQSR	True	1504	77.0	4.03	4.14	387	376	0	11	30196	30057	4	8317	335	0.9998669372276371	0.7832647104810548	exomes
truth_sample_rank	NA12878	VQSR	True	1508	78.0	3.94	4.03	387	373	0	14	30583	30430	4	7944	335	0.9998685680488927	0.7929848334810028	exomes
truth_sample_rank	NA12878	VQSR	True	1512	79.0	3.84	3.94	387	376	0	11	30970	30806	4	7568	335	0.9998701720220707	0.8027831344139261	exomes
truth_sample_rank	NA12878	VQSR	True	1516	80.0	3.74	3.84	387	376	0	11	31357	31182	4	7192	335	0.9998717373180274	0.8125814353468495	exomes
truth_sample_rank	NA12878	VQSR	True	1520	81.0	3.62	3.74	387	376	1	10	31744	31558	5	6816	334	0.999841586667934	0.8223797362797728	exomes
truth_sample_rank	NA12878	VQSR	True	1524	82.0	3.52	3.62	387	374	0	13	32131	31932	5	6442	334	0.9998434417759965	0.8321259185907125	exomes
truth_sample_rank	NA12878	VQSR	True	1528	83.0	3.4	3.52	387	373	0	14	32518	32305	5	6069	334	0.9998452491488703	0.8418460415906603	exomes
truth_sample_rank	NA12878	VQSR	True	1532	84.0	3.28	3.4	388	371	1	16	32906	32676	6	5698	333	0.9998164127042408	0.8515140459686246	exomes
truth_sample_rank	NA12878	VQSR	True	1536	85.0	3.17	3.28	387	374	0	13	33293	33050	6	5324	333	0.9998184898354308	0.8612602282795643	exomes
truth_sample_rank	NA12878	VQSR	True	1540	86.0	3.05	3.17	387	362	1	24	33680	33412	7	4962	332	0.9997905383165265	0.8706936988586021	exomes
truth_sample_rank	NA12878	VQSR	True	1544	87.0	2.95	3.05	387	368	0	19	34067	33780	7	4594	332	0.9997928197235623	0.880283525303591	exomes
truth_sample_rank	NA12878	VQSR	True	1548	88.0	2.83	2.95	387	361	0	26	34454	34141	7	4233	332	0.9997950099566593	0.889690936571637	exomes
truth_sample_rank	NA12878	VQSR	True	1552	89.0	2.68	2.83	387	362	1	24	34841	34503	8	3871	331	0.9997681898525108	0.899124407150675	exomes
truth_sample_rank	NA12878	VQSR	True	1556	90.0	2.52	2.68	387	354	0	33	35228	34857	8	3517	331	0.9997705435250251	0.9083494032417783	exomes
truth_sample_rank	NA12878	VQSR	True	1560	91.0	2.33	2.52	387	339	1	47	35615	35196	9	3178	330	0.9997443544951001	0.9171835096680043	exomes
truth_sample_rank	NA12878	VQSR	True	1564	92.0	2.14	2.33	388	334	0	54	36003	35530	9	2844	330	0.9997467570837671	0.9258873195392714	exomes
truth_sample_rank	NA12878	VQSR	True	1568	93.0	1.92	2.14	387	314	4	69	36390	35844	13	2530	326	0.9996374487547759	0.934069943190702	exomes
truth_sample_rank	NA12878	VQSR	True	1572	94.0	1.68	1.92	387	309	1	77	36777	36153	14	2221	325	0.9996129067934858	0.9421222702871737	exomes
truth_sample_rank	NA12878	VQSR	True	1576	95.0	1.44	1.68	387	318	1	68	37164	36471	15	1903	324	0.9995888834073343	0.9504091311825715	exomes
truth_sample_rank	NA12878	VQSR	True	1580	96.0	1.15	1.44	387	323	3	61	37551	36794	18	1580	321	0.9995110290122786	0.9588262886329285	exomes
truth_sample_rank	NA12878	VQSR	True	1584	97.0	0.758	1.15	387	309	2	76	37938	37103	20	1271	319	0.999461250437734	0.9668786157294001	exomes
truth_sample_rank	NA12878	VQSR	True	1588	98.0	-1.954	0.757	387	266	52	69	38325	37369	72	1005	267	0.9980769744397853	0.9738103924532235	exomes
truth_sample_rank	NA12878	VQSR	True	1592	99.0	-801.1	-1.993	387	86	266	35	38712	37455	338	919	1	0.9910565448628053	0.9760514931985198	exomes
truth_sample_rank	NA12878	VQSR	True	1596	100.0	-1.0	-1.0	1	0	1	0	38713	37455	339	919	0	0.9910303222733767	0.9760514931985198	exomes
truth_sample_rank	syndip	RF	False	793	0.0	0.8966358165834162	0.9175569526679231	17	15	0	2	17	15	0	1527	225	1.0	0.009727626459143969	exomes
truth_sample_rank	syndip	RF	False	797	1.0	0.8826693424365987	0.8959699770662531	18	13	0	5	35	28	0	1514	225	1.0	0.018158236057068743	exomes
truth_sample_rank	syndip	RF	False	801	2.0	0.873768398179859	0.8818735146025597	18	12	2	4	53	40	2	1502	223	0.9523809523809523	0.02594033722438392	exomes
truth_sample_rank	syndip	RF	False	805	3.0	0.8570922071244942	0.8727033114913569	17	10	3	4	70	50	5	1492	220	0.9090909090909091	0.0324254215304799	exomes
truth_sample_rank	syndip	RF	False	809	4.0	0.8513364129733192	0.8570401244937731	18	17	0	1	88	67	5	1475	220	0.9305555555555556	0.04345006485084306	exomes
truth_sample_rank	syndip	RF	False	813	5.0	0.8494859289075973	0.8513364129733192	18	16	0	2	106	83	5	1459	220	0.9431818181818182	0.05382619974059663	exomes
truth_sample_rank	syndip	RF	False	817	6.0	0.8436255856763092	0.849437281344701	17	13	2	2	123	96	7	1446	218	0.9320388349514563	0.0622568093385214	exomes
truth_sample_rank	syndip	RF	False	821	7.0	0.8427215400948176	0.8436255856763092	18	17	0	1	141	113	7	1429	218	0.9416666666666667	0.07328145265888457	exomes
truth_sample_rank	syndip	RF	False	825	8.0	0.8413327678736634	0.8427215400948176	18	15	0	3	159	128	7	1414	218	0.9481481481481482	0.08300907911802853	exomes
truth_sample_rank	syndip	RF	False	829	9.0	0.8402572588670955	0.8412077744926476	17	15	0	2	176	143	7	1399	218	0.9533333333333334	0.0927367055771725	exomes
truth_sample_rank	syndip	RF	False	833	10.0	0.8340176815534228	0.8389149566900018	18	13	1	4	194	156	8	1386	217	0.9512195121951219	0.10116731517509728	exomes
truth_sample_rank	syndip	RF	False	837	11.0	0.832267823137516	0.8330977294066793	18	18	0	0	212	174	8	1368	217	0.9560439560439561	0.11284046692607004	exomes
truth_sample_rank	syndip	RF	False	841	12.0	0.8315439913556929	0.832267823137516	17	16	0	1	229	190	8	1352	217	0.9595959595959596	0.12321660181582361	exomes
truth_sample_rank	syndip	RF	False	845	13.0	0.8313152207926545	0.8315439913556929	18	16	0	2	247	206	8	1336	217	0.9626168224299065	0.13359273670557717	exomes
truth_sample_rank	syndip	RF	False	849	14.0	0.8301545662858816	0.8313152207926545	18	17	0	1	265	223	8	1319	217	0.9653679653679653	0.14461738002594035	exomes
truth_sample_rank	syndip	RF	False	853	15.0	0.8273489775089675	0.8301545662858816	17	14	0	3	282	237	8	1305	217	0.9673469387755103	0.15369649805447472	exomes
truth_sample_rank	syndip	RF	False	857	16.0	0.8250009529433775	0.8270881873407936	18	16	0	2	300	253	8	1289	217	0.9693486590038314	0.16407263294422827	exomes
truth_sample_rank	syndip	RF	False	861	17.0	0.8222944333917219	0.8250009529433775	18	17	0	1	318	270	8	1272	217	0.9712230215827338	0.17509727626459143	exomes
truth_sample_rank	syndip	RF	False	865	18.0	0.821366153978848	0.8222944333917219	17	17	0	0	335	287	8	1255	217	0.9728813559322034	0.1861219195849546	exomes
truth_sample_rank	syndip	RF	False	869	19.0	0.8197793049025409	0.8213580835311838	18	17	0	1	353	304	8	1238	217	0.9743589743589743	0.19714656290531776	exomes
truth_sample_rank	syndip	RF	False	873	20.0	0.8171760617548831	0.8193450274055937	18	13	0	5	371	317	8	1225	217	0.9753846153846154	0.20557717250324253	exomes
truth_sample_rank	syndip	RF	False	877	21.0	0.814477557308186	0.817040142328362	17	12	0	5	388	329	8	1213	217	0.9762611275964391	0.2133592736705577	exomes
truth_sample_rank	syndip	RF	False	881	22.0	0.8121093498676023	0.814430841114344	18	16	0	2	406	345	8	1197	217	0.9773371104815864	0.2237354085603113	exomes
truth_sample_rank	syndip	RF	False	885	23.0	0.8105633604640337	0.8120484694256043	18	13	5	0	424	358	13	1184	212	0.9649595687331537	0.23216601815823606	exomes
truth_sample_rank	syndip	RF	False	889	24.0	0.8093825568633057	0.8105633604640337	17	17	0	0	441	375	13	1167	212	0.9664948453608248	0.24319066147859922	exomes
truth_sample_rank	syndip	RF	False	893	25.0	0.8058583259837702	0.8092855061757472	18	14	0	4	459	389	13	1153	212	0.9676616915422885	0.2522697795071336	exomes
truth_sample_rank	syndip	RF	False	897	26.0	0.8041046598136453	0.8057283071971674	18	18	0	0	477	407	13	1135	212	0.969047619047619	0.26394293125810636	exomes
truth_sample_rank	syndip	RF	False	901	27.0	0.8027303487883691	0.8040256000053696	17	16	0	1	494	423	13	1119	212	0.9701834862385321	0.27431906614785995	exomes
truth_sample_rank	syndip	RF	False	905	28.0	0.8019880544715993	0.8025903551001334	18	17	1	0	512	440	14	1102	211	0.9691629955947136	0.2853437094682231	exomes
truth_sample_rank	syndip	RF	False	909	29.0	0.8019880544715993	0.8019880544715993	18	18	0	0	530	458	14	1084	211	0.9703389830508474	0.29701686121919585	exomes
truth_sample_rank	syndip	RF	False	913	30.0	0.8013291740749138	0.8019415844275386	17	16	0	1	547	474	14	1068	211	0.9713114754098361	0.30739299610894943	exomes
truth_sample_rank	syndip	RF	False	917	31.0	0.8012827040308531	0.8013291740749138	18	18	0	0	565	492	14	1050	211	0.9723320158102767	0.31906614785992216	exomes
truth_sample_rank	syndip	RF	False	921	32.0	0.8004456770835534	0.8012265682759884	18	18	0	0	583	510	14	1032	211	0.9732824427480916	0.33073929961089493	exomes
truth_sample_rank	syndip	RF	False	925	33.0	0.7992307579174224	0.8003830817166699	17	16	0	1	600	526	14	1016	211	0.9740740740740741	0.3411154345006485	exomes
truth_sample_rank	syndip	RF	False	929	34.0	0.7976866557862141	0.7991522356353066	18	15	0	3	618	541	14	1001	211	0.9747747747747748	0.35084306095979245	exomes
truth_sample_rank	syndip	RF	False	933	35.0	0.7960011468319887	0.7976866557862141	18	16	1	1	636	557	15	985	210	0.9737762237762237	0.36121919584954604	exomes
truth_sample_rank	syndip	RF	False	937	36.0	0.7946234922797702	0.7958760222924639	17	15	1	1	653	572	16	970	209	0.9727891156462585	0.37094682230869	exomes
truth_sample_rank	syndip	RF	False	941	37.0	0.792890526223993	0.7945763720785485	18	18	0	0	671	590	16	952	209	0.9735973597359736	0.38261997405966275	exomes
truth_sample_rank	syndip	RF	False	945	38.0	0.7920127258746629	0.7928486122351872	18	18	0	0	689	608	16	934	209	0.9743589743589743	0.3942931258106355	exomes
truth_sample_rank	syndip	RF	False	949	39.0	0.7910398372644553	0.7919298012320466	17	17	0	0	706	625	16	917	209	0.9750390015600624	0.4053177691309987	exomes
truth_sample_rank	syndip	RF	False	953	40.0	0.7907763837544562	0.7910398372644553	18	17	0	1	724	642	16	900	209	0.9756838905775076	0.4163424124513619	exomes
truth_sample_rank	syndip	RF	False	957	41.0	0.7901521863047314	0.7903809568677698	18	18	0	0	742	660	16	882	209	0.9763313609467456	0.4280155642023346	exomes
truth_sample_rank	syndip	RF	False	961	42.0	0.789658158327245	0.7901521863047314	17	14	0	3	759	674	16	868	209	0.9768115942028985	0.437094682230869	exomes
truth_sample_rank	syndip	RF	False	965	43.0	0.7877743723301913	0.789658158327245	18	17	0	1	777	691	16	851	209	0.9773691654879774	0.4481193255512322	exomes
truth_sample_rank	syndip	RF	False	969	44.0	0.7865552403822272	0.7877279022861307	18	16	0	2	795	707	16	835	209	0.9778699861687413	0.4584954604409857	exomes
truth_sample_rank	syndip	RF	False	973	45.0	0.7855465210886313	0.7865552403822272	17	13	1	3	812	720	17	822	208	0.9769335142469471	0.4669260700389105	exomes
truth_sample_rank	syndip	RF	False	977	46.0	0.7842250986619457	0.7854697896906475	18	17	0	1	830	737	17	805	208	0.9774535809018567	0.4779507133592737	exomes
truth_sample_rank	syndip	RF	False	981	47.0	0.7833374477022218	0.7842250986619457	18	17	0	1	848	754	17	788	208	0.9779507133592736	0.4889753566796368	exomes
truth_sample_rank	syndip	RF	False	985	48.0	0.7794814122960388	0.7833374477022218	17	13	0	4	865	767	17	775	208	0.9783163265306123	0.4974059662775616	exomes
truth_sample_rank	syndip	RF	False	989	49.0	0.7773490703076131	0.7794236843175035	18	12	2	4	883	779	19	763	206	0.9761904761904762	0.5051880674448768	exomes
truth_sample_rank	syndip	RF	False	993	50.0	0.7713015161733278	0.777262288950693	18	13	1	4	901	792	20	750	205	0.9753694581280788	0.5136186770428015	exomes
truth_sample_rank	syndip	RF	False	997	51.0	0.7674706852132637	0.7709242536221315	17	13	0	4	918	805	20	737	205	0.9757575757575757	0.5220492866407264	exomes
truth_sample_rank	syndip	RF	False	1001	52.0	0.7610397192202435	0.7674242151692031	18	14	1	3	936	819	21	723	204	0.975	0.5311284046692607	exomes
truth_sample_rank	syndip	RF	False	1005	53.0	0.7570187164764489	0.7609421853733327	18	15	2	1	954	834	23	708	202	0.9731621936989499	0.5408560311284046	exomes
truth_sample_rank	syndip	RF	False	1009	54.0	0.7534611353849852	0.7562340903330894	17	14	0	3	971	848	23	694	202	0.9735935706084959	0.5499351491569391	exomes
truth_sample_rank	syndip	RF	False	1013	55.0	0.7503803418043616	0.7528551327743627	18	14	0	4	989	862	23	680	202	0.9740112994350283	0.5590142671854734	exomes
truth_sample_rank	syndip	RF	False	1017	56.0	0.7467153310760047	0.7503618961737357	18	14	0	4	1007	876	23	666	202	0.9744160177975528	0.5680933852140078	exomes
truth_sample_rank	syndip	RF	False	1021	57.0	0.7439541154597392	0.7464939294199038	17	15	0	2	1024	891	23	651	202	0.9748358862144421	0.5778210116731517	exomes
truth_sample_rank	syndip	RF	False	1025	58.0	0.7364769762164328	0.7434456174303278	18	15	1	2	1042	906	24	636	201	0.9741935483870968	0.5875486381322957	exomes
truth_sample_rank	syndip	RF	False	1029	59.0	0.7247817654269043	0.7358180958197473	18	13	0	5	1060	919	24	623	201	0.9745493107104984	0.5959792477302205	exomes
truth_sample_rank	syndip	RF	False	1033	60.0	0.7095546878654795	0.7235084938433584	17	15	0	2	1077	934	24	608	201	0.9749478079331941	0.6057068741893644	exomes
truth_sample_rank	syndip	RF	False	1037	61.0	0.7001038688315029	0.7092722105873254	18	11	0	7	1095	945	24	597	201	0.9752321981424149	0.6128404669260701	exomes
truth_sample_rank	syndip	RF	False	1041	62.0	0.6902864617684765	0.7000444400364337	18	14	0	4	1113	959	24	583	201	0.9755849440488301	0.6219195849546044	exomes
truth_sample_rank	syndip	RF	False	1045	63.0	0.6817475382486359	0.6900098074409573	17	15	2	0	1130	974	26	568	199	0.974	0.6316472114137484	exomes
truth_sample_rank	syndip	RF	False	1049	64.0	0.6653370239715126	0.6817010682045753	18	11	3	4	1148	985	29	557	196	0.9714003944773175	0.6387808041504539	exomes
truth_sample_rank	syndip	RF	False	1053	65.0	0.6470645030109596	0.6643439747671958	18	9	3	6	1166	994	32	548	193	0.9688109161793372	0.6446173800259404	exomes
truth_sample_rank	syndip	RF	False	1057	66.0	0.6363077396785758	0.6458234860587804	17	8	4	5	1183	1002	36	540	189	0.9653179190751445	0.6498054474708171	exomes
truth_sample_rank	syndip	RF	False	1061	67.0	0.569014918267962	0.6347752992462822	18	4	7	7	1201	1006	43	536	182	0.9590085795996187	0.6523994811932555	exomes
truth_sample_rank	syndip	RF	False	1065	68.0	0.5032334023680894	0.5635700222984392	18	11	2	5	1219	1017	45	525	180	0.9576271186440678	0.6595330739299611	exomes
truth_sample_rank	syndip	RF	False	1069	69.0	0.46098349668058963	0.503172761469359	17	10	2	5	1236	1027	47	515	178	0.9562383612662942	0.666018158236057	exomes
truth_sample_rank	syndip	RF	False	1073	70.0	0.38860697808432143	0.46098349668058963	18	9	3	6	1254	1036	50	506	175	0.9539594843462247	0.6718547341115434	exomes
truth_sample_rank	syndip	RF	False	1077	71.0	0.32614202017033206	0.38855737570293325	18	10	3	5	1272	1046	53	496	172	0.9517743403093721	0.6783398184176395	exomes
truth_sample_rank	syndip	RF	False	1081	72.0	0.30109916391111075	0.3250707038649241	17	5	6	6	1289	1051	59	491	166	0.9468468468468468	0.6815823605706874	exomes
truth_sample_rank	syndip	RF	False	1085	73.0	0.2625247414119062	0.3009786590157252	18	2	7	9	1307	1053	66	489	159	0.9410187667560321	0.6828793774319066	exomes
truth_sample_rank	syndip	RF	False	1089	74.0	0.21812482995838461	0.25835908375237304	18	3	12	3	1325	1056	78	486	147	0.9312169312169312	0.6848249027237354	exomes
truth_sample_rank	syndip	RF	False	1093	75.0	0.17175195068122348	0.21175245497119677	17	2	13	2	1342	1058	91	484	134	0.9208006962576153	0.6861219195849546	exomes
truth_sample_rank	syndip	RF	False	1097	76.0	0.16000494601726706	0.1706984854687611	18	0	18	0	1360	1058	109	484	116	0.9065981148243359	0.6861219195849546	exomes
truth_sample_rank	syndip	RF	False	1101	77.0	0.15310463082778822	0.15992282620996223	18	1	17	0	1378	1059	126	483	99	0.8936708860759494	0.6867704280155642	exomes
truth_sample_rank	syndip	RF	False	1105	78.0	0.14082229425066342	0.15298294675416738	17	0	17	0	1395	1059	143	483	82	0.8810316139767055	0.6867704280155642	exomes
truth_sample_rank	syndip	RF	False	1109	79.0	0.1276332619689124	0.1406290365863964	18	0	14	4	1413	1059	157	483	68	0.8708881578947368	0.6867704280155642	exomes
truth_sample_rank	syndip	RF	False	1113	80.0	0.10980064520213692	0.12626001298714598	18	0	17	1	1431	1059	174	483	51	0.8588807785888077	0.6867704280155642	exomes
truth_sample_rank	syndip	RF	False	1117	81.0	0.08916199076908354	0.10846527105335182	17	0	15	2	1448	1059	189	483	36	0.8485576923076923	0.6867704280155642	exomes
truth_sample_rank	syndip	RF	False	1121	82.0	0.0618216017561702	0.08783037011571729	18	1	15	2	1466	1060	204	482	21	0.8386075949367089	0.6874189364461738	exomes
truth_sample_rank	syndip	RF	False	1125	83.0	0.035805652498631976	0.06110563136210554	18	0	18	0	1484	1060	222	482	3	0.8268330733229329	0.6874189364461738	exomes
truth_sample_rank	syndip	RF	False	1129	84.0	0.024927281774009356	0.033772274857398435	17	0	3	14	1501	1060	225	482	0	0.8249027237354085	0.6874189364461738	exomes
truth_sample_rank	syndip	RF	False	1133	85.0	-1.0	-1.0	18	0	0	18	1519	1060	225	482	0	0.8249027237354085	0.6874189364461738	exomes
truth_sample_rank	syndip	RF	False	1137	86.0	-1.0	-1.0	18	0	0	18	1537	1060	225	482	0	0.8249027237354085	0.6874189364461738	exomes
truth_sample_rank	syndip	RF	False	1141	87.0	-1.0	-1.0	17	0	0	17	1554	1060	225	482	0	0.8249027237354085	0.6874189364461738	exomes
truth_sample_rank	syndip	RF	False	1145	88.0	-1.0	-1.0	18	0	0	18	1572	1060	225	482	0	0.8249027237354085	0.6874189364461738	exomes
truth_sample_rank	syndip	RF	False	1149	89.0	-1.0	-1.0	18	0	0	18	1590	1060	225	482	0	0.8249027237354085	0.6874189364461738	exomes
truth_sample_rank	syndip	RF	False	1153	90.0	-1.0	-1.0	17	0	0	17	1607	1060	225	482	0	0.8249027237354085	0.6874189364461738	exomes
truth_sample_rank	syndip	RF	False	1157	91.0	-1.0	-1.0	18	0	0	18	1625	1060	225	482	0	0.8249027237354085	0.6874189364461738	exomes
truth_sample_rank	syndip	RF	False	1161	92.0	-1.0	-1.0	18	0	0	18	1643	1060	225	482	0	0.8249027237354085	0.6874189364461738	exomes
truth_sample_rank	syndip	RF	False	1165	93.0	-1.0	-1.0	17	0	0	17	1660	1060	225	482	0	0.8249027237354085	0.6874189364461738	exomes
truth_sample_rank	syndip	RF	False	1169	94.0	-1.0	-1.0	18	0	0	18	1678	1060	225	482	0	0.8249027237354085	0.6874189364461738	exomes
truth_sample_rank	syndip	RF	False	1173	95.0	-1.0	-1.0	18	0	0	18	1696	1060	225	482	0	0.8249027237354085	0.6874189364461738	exomes
truth_sample_rank	syndip	RF	False	1177	96.0	-1.0	-1.0	17	0	0	17	1713	1060	225	482	0	0.8249027237354085	0.6874189364461738	exomes
truth_sample_rank	syndip	RF	False	1181	97.0	-1.0	-1.0	18	0	0	18	1731	1060	225	482	0	0.8249027237354085	0.6874189364461738	exomes
truth_sample_rank	syndip	RF	False	1185	98.0	-1.0	-1.0	18	0	0	18	1749	1060	225	482	0	0.8249027237354085	0.6874189364461738	exomes
truth_sample_rank	syndip	RF	False	1189	99.0	-1.0	-1.0	17	0	0	17	1766	1060	225	482	0	0.8249027237354085	0.6874189364461738	exomes
truth_sample_rank	syndip	RF	False	1193	100.0	-1.0	-1.0	1	0	0	1	1767	1060	225	482	0	0.8249027237354085	0.6874189364461738	exomes
truth_sample_rank	syndip	RF	True	1197	0.0	0.940326909875765	0.940326909875765	410	404	0	6	410	404	0	40109	538	1.0	0.009972107718510108	exomes
truth_sample_rank	syndip	RF	True	1201	1.0	0.940326909875765	0.940326909875765	411	405	0	6	821	809	0	39704	538	1.0	0.01996889887196702	exomes
truth_sample_rank	syndip	RF	True	1205	2.0	0.940326909875765	0.940326909875765	410	407	0	3	1231	1216	0	39297	538	1.0	0.03001505689531755	exomes
truth_sample_rank	syndip	RF	True	1209	3.0	0.940326909875765	0.940326909875765	411	405	0	6	1642	1621	0	38892	538	1.0	0.040011848048774466	exomes
truth_sample_rank	syndip	RF	True	1213	4.0	0.940326909875765	0.940326909875765	410	409	0	1	2052	2030	0	38483	538	1.0	0.05010737294201861	exomes
truth_sample_rank	syndip	RF	True	1217	5.0	0.940326909875765	0.940326909875765	411	406	0	5	2463	2436	0	38077	538	1.0	0.06012884753042233	exomes
truth_sample_rank	syndip	RF	True	1221	6.0	0.940326909875765	0.940326909875765	410	401	0	9	2873	2837	0	37676	538	1.0	0.07002690494409201	exomes
truth_sample_rank	syndip	RF	True	1225	7.0	0.940326909875765	0.940326909875765	411	409	0	2	3284	3246	0	37267	538	1.0	0.08012242983733617	exomes
truth_sample_rank	syndip	RF	True	1229	8.0	0.940326909875765	0.940326909875765	410	405	1	4	3694	3651	1	36862	537	0.9997261774370209	0.09011922099079307	exomes
truth_sample_rank	syndip	RF	True	1233	9.0	0.940326909875765	0.940326909875765	411	408	0	3	4105	4059	1	36454	537	0.9997536945812808	0.10019006244909041	exomes
truth_sample_rank	syndip	RF	True	1237	10.0	0.940326909875765	0.940326909875765	410	407	0	3	4515	4466	1	36047	537	0.9997761361092455	0.11023622047244094	exomes
truth_sample_rank	syndip	RF	True	1241	11.0	0.940326909875765	0.940326909875765	411	408	0	3	4926	4874	1	35639	537	0.9997948717948718	0.12030706193073828	exomes
truth_sample_rank	syndip	RF	True	1245	12.0	0.940326909875765	0.940326909875765	410	403	0	7	5336	5277	1	35236	537	0.9998105342932929	0.13025448621430158	exomes
truth_sample_rank	syndip	RF	True	1249	13.0	0.940326909875765	0.940326909875765	411	410	0	1	5747	5687	1	34826	537	0.9998241912798875	0.14037469454249255	exomes
truth_sample_rank	syndip	RF	True	1253	14.0	0.940326909875765	0.940326909875765	410	399	0	11	6157	6086	1	34427	537	0.9998357154591753	0.15022338508626862	exomes
truth_sample_rank	syndip	RF	True	1257	15.0	0.940326909875765	0.940326909875765	411	406	0	5	6568	6492	1	34021	537	0.999845987987063	0.16024485967467234	exomes
truth_sample_rank	syndip	RF	True	1261	16.0	0.940326909875765	0.940326909875765	410	404	0	6	6978	6896	1	33617	537	0.9998550094243874	0.17021696739318243	exomes
truth_sample_rank	syndip	RF	True	1265	17.0	0.940326909875765	0.940326909875765	411	409	0	2	7389	7305	1	33208	537	0.9998631261976457	0.18031249228642657	exomes
truth_sample_rank	syndip	RF	True	1269	18.0	0.940326909875765	0.940326909875765	410	407	0	3	7799	7712	1	32801	537	0.9998703487618307	0.1903586503097771	exomes
truth_sample_rank	syndip	RF	True	1273	19.0	0.940326909875765	0.940326909875765	411	410	0	1	8210	8122	1	32391	537	0.9998768927736058	0.20047885863796805	exomes
truth_sample_rank	syndip	RF	True	1277	20.0	0.940326909875765	0.940326909875765	410	407	0	3	8620	8529	1	31984	537	0.9998827667057444	0.2105250166613186	exomes
truth_sample_rank	syndip	RF	True	1281	21.0	0.940326909875765	0.940326909875765	411	405	0	6	9031	8934	1	31579	537	0.999888080581981	0.2205218078147755	exomes
truth_sample_rank	syndip	RF	True	1285	22.0	0.940326909875765	0.940326909875765	410	404	1	5	9441	9338	2	31175	536	0.9997858672376874	0.2304939155332856	exomes
truth_sample_rank	syndip	RF	True	1289	23.0	0.940326909875765	0.940326909875765	411	402	0	9	9852	9740	2	30773	536	0.9997947033463355	0.2404166563819021	exomes
truth_sample_rank	syndip	RF	True	1293	24.0	0.940326909875765	0.940326909875765	410	409	0	1	10262	10149	2	30364	536	0.9998029750763472	0.25051218127514624	exomes
truth_sample_rank	syndip	RF	True	1297	25.0	0.940326909875765	0.940326909875765	411	402	0	9	10673	10551	2	29962	536	0.9998104804321046	0.26043492212376274	exomes
truth_sample_rank	syndip	RF	True	1301	26.0	0.940326909875765	0.940326909875765	410	409	0	1	11083	10960	2	29553	536	0.9998175515416895	0.2705304470170069	exomes
truth_sample_rank	syndip	RF	True	1305	27.0	0.940326909875765	0.940326909875765	411	408	0	3	11494	11368	2	29145	536	0.9998240985048373	0.28060128847530424	exomes
truth_sample_rank	syndip	RF	True	1309	28.0	0.940326909875765	0.940326909875765	410	402	0	8	11904	11770	2	28743	536	0.9998301053346925	0.29052402932392074	exomes
truth_sample_rank	syndip	RF	True	1313	29.0	0.940326909875765	0.940326909875765	411	407	0	4	12315	12177	2	28336	536	0.9998357829050004	0.30057018734727126	exomes
truth_sample_rank	syndip	RF	True	1317	30.0	0.940326909875765	0.940326909875765	410	405	0	5	12725	12582	2	27931	536	0.9998410680228862	0.3105669785007282	exomes
truth_sample_rank	syndip	RF	True	1321	31.0	0.940326909875765	0.940326909875765	411	407	0	4	13136	12989	2	27524	536	0.9998460472634901	0.3206131365240787	exomes
truth_sample_rank	syndip	RF	True	1325	32.0	0.9398216346459711	0.940326909875765	410	399	0	11	13546	13388	2	27125	536	0.9998506348020911	0.33046182706785476	exomes
truth_sample_rank	syndip	RF	True	1329	33.0	0.9398216346459711	0.9398216346459711	411	389	0	22	13957	13777	2	26736	536	0.9998548515857464	0.34006368326216274	exomes
truth_sample_rank	syndip	RF	True	1333	34.0	0.9393634327490663	0.9398216346459711	410	404	0	6	14367	14181	2	26332	536	0.9998589861101318	0.3500357909806729	exomes
truth_sample_rank	syndip	RF	True	1337	35.0	0.9393634327490663	0.9393634327490663	411	409	0	2	14778	14590	2	25923	536	0.9998629385964912	0.360131315873917	exomes
truth_sample_rank	syndip	RF	True	1341	36.0	0.9393634327490663	0.9393634327490663	410	408	0	2	15188	14998	2	25515	536	0.9998666666666667	0.37020215733221434	exomes
truth_sample_rank	syndip	RF	True	1345	37.0	0.9393634327490663	0.9393634327490663	411	407	0	4	15599	15405	2	25108	536	0.9998701888751866	0.38024831535556486	exomes
truth_sample_rank	syndip	RF	True	1349	38.0	0.9393634327490663	0.9393634327490663	410	407	0	3	16009	15812	2	24701	536	0.9998735297837359	0.39029447337891543	exomes
truth_sample_rank	syndip	RF	True	1353	39.0	0.9393634327490663	0.9393634327490663	411	408	0	3	16420	16220	2	24293	536	0.9998767106398718	0.40036531483721277	exomes
truth_sample_rank	syndip	RF	True	1357	40.0	0.9393634327490663	0.9393634327490663	410	404	2	4	16830	16624	4	23889	534	0.9997594419052201	0.41033742255572286	exomes
truth_sample_rank	syndip	RF	True	1361	41.0	0.9393634327490663	0.9393634327490663	411	407	0	4	17241	17031	4	23482	534	0.9997651893161139	0.4203835805790734	exomes
truth_sample_rank	syndip	RF	True	1365	42.0	0.9393634327490663	0.9393634327490663	410	408	0	2	17651	17439	4	23074	534	0.9997706816487989	0.4304544220373707	exomes
truth_sample_rank	syndip	RF	True	1369	43.0	0.9393634327490663	0.9393634327490663	411	406	1	4	18062	17845	5	22668	533	0.9997198879551821	0.44047589662577447	exomes
truth_sample_rank	syndip	RF	True	1373	44.0	0.9388581575192725	0.9393634327490663	410	408	0	2	18472	18253	5	22260	533	0.9997261474422171	0.45054673808407175	exomes
truth_sample_rank	syndip	RF	True	1377	45.0	0.9359289229606387	0.9388581575192725	411	400	0	11	18883	18653	5	21860	533	0.9997320184371316	0.46042011206279465	exomes
truth_sample_rank	syndip	RF	True	1381	46.0	0.9274199866805862	0.9359289229606387	410	380	1	29	19293	19033	6	21480	532	0.9996848573979726	0.4697998173425814	exomes
truth_sample_rank	syndip	RF	True	1385	47.0	0.9246641508428851	0.9274199866805862	411	406	0	5	19704	19439	6	21074	532	0.9996914373875032	0.4798212919309851	exomes
truth_sample_rank	syndip	RF	True	1389	48.0	0.9246641508428851	0.9246641508428851	410	400	0	10	20114	19839	6	20674	532	0.999697656840514	0.489694665909708	exomes
truth_sample_rank	syndip	RF	True	1393	49.0	0.9246641508428851	0.9246641508428851	411	401	0	10	20525	20240	6	20273	532	0.999703645164477	0.4995927233233777	exomes
truth_sample_rank	syndip	RF	True	1397	50.0	0.9246641508428851	0.9246641508428851	411	396	0	15	20936	20636	6	19877	532	0.9997093304912315	0.5093673635623134	exomes
truth_sample_rank	syndip	RF	True	1401	51.0	0.9246641508428851	0.9246641508428851	410	406	0	4	21346	21042	6	19471	532	0.999714937286203	0.519388838150717	exomes
truth_sample_rank	syndip	RF	True	1405	52.0	0.9246641508428851	0.9246641508428851	411	400	0	11	21757	21442	6	19071	532	0.9997202536367027	0.5292622121294399	exomes
truth_sample_rank	syndip	RF	True	1409	53.0	0.9246641508428851	0.9246641508428851	410	396	0	14	22167	21838	6	18675	532	0.9997253250320454	0.5390368523683756	exomes
truth_sample_rank	syndip	RF	True	1413	54.0	0.9246641508428851	0.9246641508428851	411	407	0	4	22578	22245	6	18268	532	0.9997303491977889	0.5490830103917261	exomes
truth_sample_rank	syndip	RF	True	1417	55.0	0.9246641508428851	0.9246641508428851	410	406	0	4	22988	22651	6	17862	532	0.9997351811802092	0.5591044849801299	exomes
truth_sample_rank	syndip	RF	True	1421	56.0	0.9246641508428851	0.9246641508428851	411	405	0	6	23399	23056	6	17457	532	0.9997398317578701	0.5691012761335867	exomes
truth_sample_rank	syndip	RF	True	1425	57.0	0.9246641508428851	0.9246641508428851	410	400	0	10	23809	23456	6	17057	532	0.9997442673258887	0.5789746501123096	exomes
truth_sample_rank	syndip	RF	True	1429	58.0	0.9246641508428851	0.9246641508428851	411	404	0	7	24220	23860	6	16653	532	0.9997485963295064	0.5889467578308197	exomes
truth_sample_rank	syndip	RF	True	1433	59.0	0.9246641508428851	0.9246641508428851	410	406	0	4	24630	24266	6	16247	532	0.9997528015820699	0.5989682324192235	exomes
truth_sample_rank	syndip	RF	True	1437	60.0	0.9246641508428851	0.9246641508428851	411	401	0	10	25041	24667	6	15846	532	0.9997568191950715	0.6088662898328931	exomes
truth_sample_rank	syndip	RF	True	1441	61.0	0.9246641508428851	0.9246641508428851	410	404	0	6	25451	25071	6	15442	532	0.9997607369302548	0.6188383975514032	exomes
truth_sample_rank	syndip	RF	True	1445	62.0	0.9246641508428851	0.9246641508428851	411	401	0	10	25862	25472	6	15041	532	0.9997645027082188	0.6287364549650729	exomes
truth_sample_rank	syndip	RF	True	1449	63.0	0.9241588756130913	0.9246641508428851	410	388	1	21	26272	25860	7	14653	531	0.9997293849306066	0.6383136277244341	exomes
truth_sample_rank	syndip	RF	True	1453	64.0	0.9240360250036639	0.9241588756130913	411	387	0	24	26683	26247	7	14266	531	0.999733373962063	0.6478661170488486	exomes
truth_sample_rank	syndip	RF	True	1457	65.0	0.9240360250036639	0.9240360250036639	410	405	0	5	27093	26652	7	13861	531	0.9997374245095465	0.6578629082023054	exomes
truth_sample_rank	syndip	RF	True	1461	66.0	0.9240360250036639	0.9240360250036639	411	409	0	2	27504	27061	7	13452	531	0.9997413920496527	0.6679584330955496	exomes
truth_sample_rank	syndip	RF	True	1465	67.0	0.9240360250036639	0.9240360250036639	410	407	0	3	27914	27468	7	13045	531	0.9997452229299363	0.6780045911189001	exomes
truth_sample_rank	syndip	RF	True	1469	68.0	0.9240360250036639	0.9240360250036639	411	406	0	5	28325	27874	7	12639	531	0.9997489329651017	0.6880260657073038	exomes
truth_sample_rank	syndip	RF	True	1473	69.0	0.9216875138062478	0.9240360250036639	410	397	0	13	28735	28271	7	12242	531	0.9997524577410001	0.6978253893811863	exomes
truth_sample_rank	syndip	RF	True	1477	70.0	0.9181504628942568	0.9216875138062478	411	410	0	1	29146	28681	7	11832	531	0.9997559955382042	0.7079455977093773	exomes
truth_sample_rank	syndip	RF	True	1481	71.0	0.9174937404754375	0.9181504628942568	410	387	0	23	29556	29068	7	11445	531	0.9997592433361995	0.7174980870337916	exomes
truth_sample_rank	syndip	RF	True	1485	72.0	0.9169985164742522	0.9174937404754375	411	394	0	17	29967	29462	7	11051	531	0.9997624622484644	0.7272233604028336	exomes
truth_sample_rank	syndip	RF	True	1489	73.0	0.9169985164742522	0.9169985164742522	410	401	1	8	30377	29863	8	10650	530	0.9997321817147066	0.7371214178165033	exomes
truth_sample_rank	syndip	RF	True	1493	74.0	0.9164468474745467	0.9169985164742522	411	397	0	14	30788	30260	8	10253	530	0.999735694462799	0.7469207414903858	exomes
truth_sample_rank	syndip	RF	True	1497	75.0	0.9159183442800394	0.9164468474745467	410	395	0	15	31198	30655	8	9858	530	0.9997390992401265	0.7566706982943746	exomes
truth_sample_rank	syndip	RF	True	1501	76.0	0.9133297710621514	0.9159183442800394	411	362	0	49	31609	31017	8	9496	530	0.9997421434327155	0.7656061017451189	exomes
truth_sample_rank	syndip	RF	True	1505	77.0	0.9102530939627698	0.9133297710621514	410	389	0	21	32019	31406	8	9107	530	0.9997453364741835	0.7752079579394269	exomes
truth_sample_rank	syndip	RF	True	1509	78.0	0.905169723556892	0.9102530939627698	411	259	0	152	32430	31665	8	8848	530	0.9997474189372652	0.7816009675906499	exomes
truth_sample_rank	syndip	RF	True	1513	79.0	0.905169723556892	0.905169723556892	410	406	0	4	32840	32071	8	8442	530	0.9997506156675707	0.7916224421790536	exomes
truth_sample_rank	syndip	RF	True	1517	80.0	0.9040087888781468	0.905169723556892	411	399	1	11	33251	32470	9	8043	529	0.9997228978724715	0.8014711327228297	exomes
truth_sample_rank	syndip	RF	True	1521	81.0	0.9029707391391926	0.9040087888781468	410	403	1	6	33661	32873	10	7640	528	0.9996958914940851	0.811418557006393	exomes
truth_sample_rank	syndip	RF	True	1525	82.0	0.9016567046835344	0.9029707391391926	411	391	1	19	34072	33264	11	7249	527	0.9996694214876033	0.8210697800705946	exomes
truth_sample_rank	syndip	RF	True	1529	83.0	0.8994515260004692	0.9016567046835344	410	396	0	14	34482	33660	11	6853	527	0.999673309376021	0.8308444203095303	exomes
truth_sample_rank	syndip	RF	True	1533	84.0	0.8874670438822844	0.8994515260004692	411	364	1	46	34893	34024	12	6489	526	0.9996474321306852	0.8398291906301681	exomes
truth_sample_rank	syndip	RF	True	1537	85.0	0.8845379648997925	0.8873381379674168	410	386	0	24	35303	34410	12	6103	526	0.9996513857416769	0.8493569965196357	exomes
truth_sample_rank	syndip	RF	True	1541	86.0	0.8720095917767344	0.8845379648997925	411	382	2	27	35714	34792	14	5721	524	0.9995977704993392	0.8587860686693161	exomes
truth_sample_rank	syndip	RF	True	1545	87.0	0.867086141264274	0.8720095917767344	410	387	3	20	36124	35179	17	5334	521	0.9995169905671099	0.8683385579937304	exomes
truth_sample_rank	syndip	RF	True	1549	88.0	0.8631565137659288	0.867086141264274	411	396	0	15	36535	35575	17	4938	521	0.9995223645763093	0.8781131982326661	exomes
truth_sample_rank	syndip	RF	True	1553	89.0	0.8582426802245239	0.8631565137659288	410	391	0	19	36945	35966	17	4547	521	0.9995275546785982	0.8877644212968677	exomes
truth_sample_rank	syndip	RF	True	1557	90.0	0.8553837790888831	0.8582426802245239	411	391	0	20	37356	36357	17	4156	521	0.9995326331995381	0.8974156443610692	exomes
truth_sample_rank	syndip	RF	True	1561	91.0	0.8411793924250326	0.8552895174492354	410	368	0	42	37766	36725	17	3788	521	0.9995373142452779	0.9064991484214944	exomes
truth_sample_rank	syndip	RF	True	1565	92.0	0.8340051467612799	0.8411309373784492	411	385	2	24	38177	37110	19	3403	519	0.9994882706240406	0.9160022708760152	exomes
truth_sample_rank	syndip	RF	True	1569	93.0	0.8217386309345602	0.8340051467612799	410	357	0	53	38587	37467	19	3046	519	0.9994931441071333	0.9248142571520253	exomes
truth_sample_rank	syndip	RF	True	1573	94.0	0.8063797807842096	0.8217386309345602	411	332	1	78	38998	37799	20	2714	518	0.9994711652872894	0.9330091575543653	exomes
truth_sample_rank	syndip	RF	True	1577	95.0	0.7706422165336232	0.8062708188268213	410	356	1	53	39408	38155	21	2358	517	0.9994499161777033	0.9417964603954286	exomes
truth_sample_rank	syndip	RF	True	1581	96.0	0.6096500305085591	0.7705346559411572	411	309	16	86	39819	38464	37	2049	501	0.9990389860003637	0.9494236417939921	exomes
truth_sample_rank	syndip	RF	True	1585	97.0	0.40342789254564465	0.6096500305085591	410	244	26	140	40229	38708	63	1805	475	0.998375074153362	0.955446399921013	exomes
truth_sample_rank	syndip	RF	True	1589	98.0	0.0818984691237707	0.40127178475352876	411	137	213	61	40640	38845	276	1668	262	0.9929449656194883	0.9588280305087256	exomes
truth_sample_rank	syndip	RF	True	1593	99.0	0.010546956365827044	0.08175999568130085	410	48	262	100	41050	38893	538	1620	0	0.9863559128604398	0.9600128353861723	exomes
truth_sample_rank	syndip	RF	True	1597	100.0	-1.0	-1.0	1	0	0	1	41051	38893	538	1620	0	0.9863559128604398	0.9600128353861723	exomes
truth_sample_rank	syndip	VQSR	False	794	0.0	7.28	7.58	17	15	1	1	17	15	1	1527	224	0.9375	0.009727626459143969	exomes
truth_sample_rank	syndip	VQSR	False	798	1.0	7.11	7.27	18	17	1	0	35	32	2	1510	223	0.9411764705882353	0.020752269779507133	exomes
truth_sample_rank	syndip	VQSR	False	802	2.0	6.98	7.1	18	17	1	0	53	49	3	1493	222	0.9423076923076923	0.031776913099870296	exomes
truth_sample_rank	syndip	VQSR	False	806	3.0	6.84	6.95	17	17	0	0	70	66	3	1476	222	0.9565217391304348	0.042801556420233464	exomes
truth_sample_rank	syndip	VQSR	False	810	4.0	6.72	6.84	18	18	0	0	88	84	3	1458	222	0.9655172413793104	0.054474708171206226	exomes
truth_sample_rank	syndip	VQSR	False	814	5.0	6.63	6.71	18	16	0	2	106	100	3	1442	222	0.970873786407767	0.0648508430609598	exomes
truth_sample_rank	syndip	VQSR	False	818	6.0	6.48	6.62	17	15	1	1	123	115	4	1427	221	0.9663865546218487	0.07457846952010376	exomes
truth_sample_rank	syndip	VQSR	False	822	7.0	6.34	6.47	18	18	0	0	141	133	4	1409	221	0.9708029197080292	0.08625162127107652	exomes
truth_sample_rank	syndip	VQSR	False	826	8.0	6.22	6.33	18	18	0	0	159	151	4	1391	221	0.9741935483870968	0.09792477302204929	exomes
truth_sample_rank	syndip	VQSR	False	830	9.0	6.07	6.22	17	15	1	1	176	166	5	1376	220	0.9707602339181286	0.10765239948119326	exomes
truth_sample_rank	syndip	VQSR	False	834	10.0	5.98	6.07	18	13	1	4	194	179	6	1363	219	0.9675675675675676	0.11608300907911803	exomes
truth_sample_rank	syndip	VQSR	False	838	11.0	5.86	5.96	18	17	1	0	212	196	7	1346	218	0.9655172413793104	0.12710765239948119	exomes
truth_sample_rank	syndip	VQSR	False	842	12.0	5.8	5.86	17	17	0	0	229	213	7	1329	218	0.9681818181818181	0.13813229571984437	exomes
truth_sample_rank	syndip	VQSR	False	846	13.0	5.72	5.8	18	15	1	2	247	228	8	1314	217	0.9661016949152542	0.14785992217898833	exomes
truth_sample_rank	syndip	VQSR	False	850	14.0	5.59	5.72	18	16	1	1	265	244	9	1298	216	0.9644268774703557	0.1582360570687419	exomes
truth_sample_rank	syndip	VQSR	False	854	15.0	5.47	5.58	17	15	0	2	282	259	9	1283	216	0.9664179104477612	0.16796368352788585	exomes
truth_sample_rank	syndip	VQSR	False	858	16.0	5.4	5.47	18	16	0	2	300	275	9	1267	216	0.9683098591549296	0.17833981841763943	exomes
truth_sample_rank	syndip	VQSR	False	862	17.0	5.32	5.39	18	18	0	0	318	293	9	1249	216	0.9701986754966887	0.19001297016861218	exomes
truth_sample_rank	syndip	VQSR	False	866	18.0	5.22	5.32	17	14	2	1	335	307	11	1235	214	0.9654088050314465	0.19909208819714655	exomes
truth_sample_rank	syndip	VQSR	False	870	19.0	5.12	5.22	18	17	1	0	353	324	12	1218	213	0.9642857142857143	0.21011673151750973	exomes
truth_sample_rank	syndip	VQSR	False	874	20.0	4.96	5.12	18	16	1	1	371	340	13	1202	212	0.9631728045325779	0.2204928664072633	exomes
truth_sample_rank	syndip	VQSR	False	878	21.0	4.86	4.95	17	13	1	3	388	353	14	1189	211	0.9618528610354223	0.22892347600518806	exomes
truth_sample_rank	syndip	VQSR	False	882	22.0	4.76	4.86	18	13	5	0	406	366	19	1176	206	0.9506493506493506	0.23735408560311283	exomes
truth_sample_rank	syndip	VQSR	False	886	23.0	4.58	4.76	18	13	3	2	424	379	22	1163	203	0.9451371571072319	0.2457846952010376	exomes
truth_sample_rank	syndip	VQSR	False	890	24.0	4.43	4.57	17	14	2	1	441	393	24	1149	201	0.9424460431654677	0.25486381322957197	exomes
truth_sample_rank	syndip	VQSR	False	894	25.0	4.32	4.42	18	13	3	2	459	406	27	1136	198	0.9376443418013857	0.26329442282749677	exomes
truth_sample_rank	syndip	VQSR	False	898	26.0	4.27	4.32	18	15	2	1	477	421	29	1121	196	0.9355555555555556	0.2730220492866407	exomes
truth_sample_rank	syndip	VQSR	False	902	27.0	4.18	4.25	17	14	2	1	494	435	31	1107	194	0.9334763948497854	0.2821011673151751	exomes
truth_sample_rank	syndip	VQSR	False	906	28.0	4.11	4.18	18	13	2	3	512	448	33	1094	192	0.9313929313929314	0.2905317769130999	exomes
truth_sample_rank	syndip	VQSR	False	910	29.0	4.02	4.11	18	15	0	3	530	463	33	1079	192	0.9334677419354839	0.3002594033722438	exomes
truth_sample_rank	syndip	VQSR	False	914	30.0	3.95	4.02	17	13	3	1	547	476	36	1066	189	0.9296875	0.3086900129701686	exomes
truth_sample_rank	syndip	VQSR	False	918	31.0	3.85	3.94	18	15	1	2	565	491	37	1051	188	0.9299242424242424	0.31841763942931256	exomes
truth_sample_rank	syndip	VQSR	False	922	32.0	3.79	3.85	18	15	2	1	583	506	39	1036	186	0.9284403669724771	0.32814526588845655	exomes
truth_sample_rank	syndip	VQSR	False	926	33.0	3.7	3.79	17	13	0	4	600	519	39	1023	186	0.9301075268817204	0.33657587548638135	exomes
truth_sample_rank	syndip	VQSR	False	930	34.0	3.63	3.7	18	16	2	0	618	535	41	1007	184	0.9288194444444444	0.3469520103761349	exomes
truth_sample_rank	syndip	VQSR	False	934	35.0	3.56	3.63	18	17	1	0	636	552	42	990	183	0.9292929292929293	0.35797665369649806	exomes
truth_sample_rank	syndip	VQSR	False	938	36.0	3.48	3.55	17	11	5	1	653	563	47	979	178	0.9229508196721311	0.3651102464332036	exomes
truth_sample_rank	syndip	VQSR	False	942	37.0	3.42	3.47	18	7	9	2	671	570	56	972	169	0.9105431309904153	0.36964980544747084	exomes
truth_sample_rank	syndip	VQSR	False	946	38.0	3.38	3.42	18	14	2	2	689	584	58	958	167	0.9096573208722741	0.3787289234760052	exomes
truth_sample_rank	syndip	VQSR	False	950	39.0	3.29	3.38	17	12	2	3	706	596	60	946	165	0.9085365853658537	0.3865110246433204	exomes
truth_sample_rank	syndip	VQSR	False	954	40.0	3.22	3.29	18	11	4	3	724	607	64	935	161	0.9046199701937406	0.39364461738002593	exomes
truth_sample_rank	syndip	VQSR	False	958	41.0	3.16	3.22	18	14	3	1	742	621	67	921	158	0.9026162790697675	0.4027237354085603	exomes
truth_sample_rank	syndip	VQSR	False	962	42.0	3.09	3.15	17	11	4	2	759	632	71	910	154	0.89900426742532	0.4098573281452659	exomes
truth_sample_rank	syndip	VQSR	False	966	43.0	3.03	3.09	18	15	0	3	777	647	71	895	154	0.9011142061281338	0.41958495460440987	exomes
truth_sample_rank	syndip	VQSR	False	970	44.0	2.95	3.03	18	17	1	0	795	664	72	878	153	0.9021739130434783	0.43060959792477305	exomes
truth_sample_rank	syndip	VQSR	False	974	45.0	2.91	2.95	17	13	1	3	812	677	73	865	152	0.9026666666666666	0.4390402075226978	exomes
truth_sample_rank	syndip	VQSR	False	978	46.0	2.85	2.91	18	14	2	2	830	691	75	851	150	0.902088772845953	0.4481193255512322	exomes
truth_sample_rank	syndip	VQSR	False	982	47.0	2.76	2.85	18	11	1	6	848	702	76	840	149	0.9023136246786633	0.45525291828793774	exomes
truth_sample_rank	syndip	VQSR	False	986	48.0	2.69	2.75	17	14	2	1	865	716	78	826	147	0.9017632241813602	0.46433203631647213	exomes
truth_sample_rank	syndip	VQSR	False	990	49.0	2.61	2.69	18	12	4	2	883	728	82	814	143	0.8987654320987655	0.4721141374837873	exomes
truth_sample_rank	syndip	VQSR	False	994	50.0	2.51	2.61	18	16	2	0	901	744	84	798	141	0.8985507246376812	0.48249027237354086	exomes
truth_sample_rank	syndip	VQSR	False	998	51.0	2.41	2.51	17	13	1	3	918	757	85	785	140	0.8990498812351544	0.4909208819714656	exomes
truth_sample_rank	syndip	VQSR	False	1002	52.0	2.31	2.4	18	14	3	1	936	771	88	771	137	0.8975552968568102	0.5	exomes
truth_sample_rank	syndip	VQSR	False	1006	53.0	2.22	2.31	18	10	5	3	954	781	93	761	132	0.8935926773455377	0.506485084306096	exomes
truth_sample_rank	syndip	VQSR	False	1010	54.0	2.16	2.22	17	8	2	7	971	789	95	753	130	0.8925339366515838	0.5116731517509727	exomes
truth_sample_rank	syndip	VQSR	False	1014	55.0	2.09	2.16	18	13	2	3	989	802	97	740	128	0.8921023359288098	0.5201037613488976	exomes
truth_sample_rank	syndip	VQSR	False	1018	56.0	1.98	2.08	18	12	1	5	1007	814	98	728	127	0.8925438596491229	0.5278858625162127	exomes
truth_sample_rank	syndip	VQSR	False	1022	57.0	1.92	1.97	17	10	1	6	1024	824	99	718	126	0.8927410617551462	0.5343709468223087	exomes
truth_sample_rank	syndip	VQSR	False	1026	58.0	1.83	1.92	18	15	0	3	1042	839	99	703	126	0.894456289978678	0.5440985732814526	exomes
truth_sample_rank	syndip	VQSR	False	1030	59.0	1.76	1.83	18	16	1	1	1060	855	100	687	125	0.8952879581151832	0.5544747081712063	exomes
truth_sample_rank	syndip	VQSR	False	1034	60.0	1.67	1.76	17	11	2	4	1077	866	102	676	123	0.8946280991735537	0.5616083009079118	exomes
truth_sample_rank	syndip	VQSR	False	1038	61.0	1.58	1.66	18	13	2	3	1095	879	104	663	121	0.8942014242115972	0.5700389105058365	exomes
truth_sample_rank	syndip	VQSR	False	1042	62.0	1.44	1.56	18	12	2	4	1113	891	106	651	119	0.8936810431293881	0.5778210116731517	exomes
truth_sample_rank	syndip	VQSR	False	1046	63.0	1.33	1.42	17	11	3	3	1130	902	109	640	116	0.8921859545004945	0.5849546044098574	exomes
truth_sample_rank	syndip	VQSR	False	1050	64.0	1.22	1.32	18	15	1	2	1148	917	110	625	115	0.8928919182083739	0.5946822308690013	exomes
truth_sample_rank	syndip	VQSR	False	1054	65.0	1.15	1.22	18	15	1	2	1166	932	111	610	114	0.8935762224352828	0.6044098573281452	exomes
truth_sample_rank	syndip	VQSR	False	1058	66.0	1.08	1.15	17	6	6	5	1183	938	117	604	108	0.8890995260663507	0.6083009079118028	exomes
truth_sample_rank	syndip	VQSR	False	1062	67.0	1.01	1.08	18	11	3	4	1201	949	120	593	105	0.8877455565949486	0.6154345006485085	exomes
truth_sample_rank	syndip	VQSR	False	1066	68.0	0.925	1.01	18	12	4	2	1219	961	124	581	101	0.8857142857142857	0.6232166018158236	exomes
truth_sample_rank	syndip	VQSR	False	1070	69.0	0.764	0.921	17	12	3	2	1236	973	127	569	98	0.8845454545454545	0.6309987029831388	exomes
truth_sample_rank	syndip	VQSR	False	1074	70.0	0.615	0.756	18	12	1	5	1254	985	128	557	97	0.8849955076370171	0.6387808041504539	exomes
truth_sample_rank	syndip	VQSR	False	1078	71.0	0.433	0.586	18	13	2	3	1272	998	130	544	95	0.8847517730496454	0.6472114137483788	exomes
truth_sample_rank	syndip	VQSR	False	1082	72.0	0.276	0.427	17	9	4	4	1289	1007	134	535	91	0.8825591586327782	0.6530479896238651	exomes
truth_sample_rank	syndip	VQSR	False	1086	73.0	0.028	0.271	18	11	1	6	1307	1018	135	524	90	0.8829141370338248	0.6601815823605707	exomes
truth_sample_rank	syndip	VQSR	False	1090	74.0	-0.2135	-0.0097	18	5	4	9	1325	1023	139	519	86	0.8803786574870912	0.6634241245136187	exomes
truth_sample_rank	syndip	VQSR	False	1094	75.0	-0.3174	-0.223	17	5	3	9	1342	1028	142	514	83	0.8786324786324786	0.6666666666666666	exomes
truth_sample_rank	syndip	VQSR	False	1098	76.0	-0.483	-0.321	18	9	4	5	1360	1037	146	505	79	0.8765849535080305	0.6725032425421531	exomes
truth_sample_rank	syndip	VQSR	False	1102	77.0	-0.8353	-0.4866	18	9	2	7	1378	1046	148	496	77	0.8760469011725294	0.6783398184176395	exomes
truth_sample_rank	syndip	VQSR	False	1106	78.0	-1.24	-0.8429	17	6	2	9	1395	1052	150	490	75	0.8752079866888519	0.682230869001297	exomes
truth_sample_rank	syndip	VQSR	False	1110	79.0	-2.128	-1.28	18	3	10	5	1413	1055	160	487	65	0.8683127572016461	0.6841763942931258	exomes
truth_sample_rank	syndip	VQSR	False	1114	80.0	-9.36	-2.157	18	1	13	4	1431	1056	173	486	52	0.8592351505288853	0.6848249027237354	exomes
truth_sample_rank	syndip	VQSR	False	1118	81.0	-24.58	-10.14	17	0	17	0	1448	1056	190	486	35	0.8475120385232745	0.6848249027237354	exomes
truth_sample_rank	syndip	VQSR	False	1122	82.0	-99.77	-24.75	18	1	17	0	1466	1057	207	485	18	0.8362341772151899	0.685473411154345	exomes
truth_sample_rank	syndip	VQSR	False	1126	83.0	-123.0	-115.2	18	1	2	15	1484	1058	209	484	16	0.835043409629045	0.6861219195849546	exomes
truth_sample_rank	syndip	VQSR	False	1130	84.0	-1.0	-1.0	17	0	1	16	1501	1058	210	484	15	0.8343848580441641	0.6861219195849546	exomes
truth_sample_rank	syndip	VQSR	False	1134	85.0	-1.0	-1.0	18	0	1	17	1519	1058	211	484	14	0.8337273443656422	0.6861219195849546	exomes
truth_sample_rank	syndip	VQSR	False	1138	86.0	-1.0	-1.0	18	0	0	18	1537	1058	211	484	14	0.8337273443656422	0.6861219195849546	exomes
truth_sample_rank	syndip	VQSR	False	1142	87.0	-1.0	-1.0	17	1	0	16	1554	1059	211	483	14	0.8338582677165355	0.6867704280155642	exomes
truth_sample_rank	syndip	VQSR	False	1146	88.0	-1.0	-1.0	18	1	0	17	1572	1060	211	482	14	0.8339889850511408	0.6874189364461738	exomes
truth_sample_rank	syndip	VQSR	False	1150	89.0	-1.0	-1.0	18	0	0	18	1590	1060	211	482	14	0.8339889850511408	0.6874189364461738	exomes
truth_sample_rank	syndip	VQSR	False	1154	90.0	-1.0	-1.0	17	0	1	16	1607	1060	212	482	13	0.8333333333333334	0.6874189364461738	exomes
truth_sample_rank	syndip	VQSR	False	1158	91.0	-1.0	-1.0	18	0	2	16	1625	1060	214	482	11	0.8320251177394035	0.6874189364461738	exomes
truth_sample_rank	syndip	VQSR	False	1162	92.0	-1.0	-1.0	18	0	2	16	1643	1060	216	482	9	0.8307210031347962	0.6874189364461738	exomes
truth_sample_rank	syndip	VQSR	False	1166	93.0	-1.0	-1.0	17	0	1	16	1660	1060	217	482	8	0.8300704776820673	0.6874189364461738	exomes
truth_sample_rank	syndip	VQSR	False	1170	94.0	-1.0	-1.0	18	0	1	17	1678	1060	218	482	7	0.8294209702660407	0.6874189364461738	exomes
truth_sample_rank	syndip	VQSR	False	1174	95.0	-1.0	-1.0	18	0	2	16	1696	1060	220	482	5	0.828125	0.6874189364461738	exomes
truth_sample_rank	syndip	VQSR	False	1178	96.0	-1.0	-1.0	17	0	2	15	1713	1060	222	482	3	0.8268330733229329	0.6874189364461738	exomes
truth_sample_rank	syndip	VQSR	False	1182	97.0	-1.0	-1.0	18	0	3	15	1731	1060	225	482	0	0.8249027237354085	0.6874189364461738	exomes
truth_sample_rank	syndip	VQSR	False	1186	98.0	-1.0	-1.0	18	0	0	18	1749	1060	225	482	0	0.8249027237354085	0.6874189364461738	exomes
truth_sample_rank	syndip	VQSR	False	1190	99.0	-1.0	-1.0	17	0	0	17	1766	1060	225	482	0	0.8249027237354085	0.6874189364461738	exomes
truth_sample_rank	syndip	VQSR	False	1194	100.0	-1.0	-1.0	1	0	0	1	1767	1060	225	482	0	0.8249027237354085	0.6874189364461738	exomes
truth_sample_rank	syndip	VQSR	True	1198	0.0	8.16	9.0	410	410	0	0	410	410	0	40103	538	1.0	0.01012020832819095	exomes
truth_sample_rank	syndip	VQSR	True	1202	1.0	7.94	8.16	411	411	0	0	821	821	0	39692	538	1.0	0.02026510009132871	exomes
truth_sample_rank	syndip	VQSR	True	1206	2.0	7.78	7.94	410	409	1	0	1231	1230	1	39283	537	0.9991876523151909	0.030360624984572853	exomes
truth_sample_rank	syndip	VQSR	True	1210	3.0	7.64	7.78	411	411	0	0	1642	1641	1	38872	537	0.9993909866017052	0.040505516747710614	exomes
truth_sample_rank	syndip	VQSR	True	1214	4.0	7.5	7.64	410	410	0	0	2052	2051	1	38462	537	0.9995126705653021	0.05062572507590156	exomes
truth_sample_rank	syndip	VQSR	True	1218	5.0	7.39	7.5	411	411	0	0	2463	2462	1	38051	537	0.9995939910678034	0.060770616839039324	exomes
truth_sample_rank	syndip	VQSR	True	1222	6.0	7.29	7.39	410	409	0	1	2873	2871	1	37642	537	0.9996518105849582	0.07086614173228346	exomes
truth_sample_rank	syndip	VQSR	True	1226	7.0	7.19	7.29	411	411	0	0	3284	3282	1	37231	537	0.999695400548279	0.08101103349542123	exomes
truth_sample_rank	syndip	VQSR	True	1230	8.0	7.1	7.19	410	409	0	1	3694	3691	1	36822	537	0.9997291440953413	0.09110655838866537	exomes
truth_sample_rank	syndip	VQSR	True	1234	9.0	7.02	7.1	411	410	1	0	4105	4101	2	36412	536	0.9995125517913722	0.10122676671685632	exomes
truth_sample_rank	syndip	VQSR	True	1238	10.0	6.94	7.02	410	409	0	1	4515	4510	2	36003	536	0.9995567375886525	0.11132229161010046	exomes
truth_sample_rank	syndip	VQSR	True	1242	11.0	6.86	6.94	411	411	0	0	4926	4921	2	35592	536	0.9995937436522445	0.12146718337323822	exomes
truth_sample_rank	syndip	VQSR	True	1246	12.0	6.79	6.86	410	410	0	0	5336	5331	2	35182	536	0.9996249765610351	0.13158739170142916	exomes
truth_sample_rank	syndip	VQSR	True	1250	13.0	6.73	6.79	411	409	0	2	5747	5740	2	34773	536	0.9996516893068618	0.1416829165946733	exomes
truth_sample_rank	syndip	VQSR	True	1254	14.0	6.68	6.73	410	410	0	0	6157	6150	2	34363	536	0.9996749024707412	0.15180312492286427	exomes
truth_sample_rank	syndip	VQSR	True	1258	15.0	6.62	6.68	411	409	0	2	6568	6559	2	33954	536	0.9996951684194483	0.1618986498161084	exomes
truth_sample_rank	syndip	VQSR	True	1262	16.0	6.58	6.62	410	409	0	1	6978	6968	2	33545	536	0.999713055954089	0.17199417470935255	exomes
truth_sample_rank	syndip	VQSR	True	1266	17.0	6.53	6.58	411	410	0	1	7389	7378	2	33135	536	0.9997289972899729	0.18211438303754351	exomes
truth_sample_rank	syndip	VQSR	True	1270	18.0	6.49	6.53	410	410	0	0	7799	7788	2	32725	536	0.9997432605905007	0.19223459136573445	exomes
truth_sample_rank	syndip	VQSR	True	1274	19.0	6.44	6.49	411	407	0	4	8210	8195	2	32318	536	0.999756008295718	0.202280749389085	exomes
truth_sample_rank	syndip	VQSR	True	1278	20.0	6.4	6.44	410	409	0	1	8620	8604	2	31909	536	0.9997676039972112	0.21237627428232914	exomes
truth_sample_rank	syndip	VQSR	True	1282	21.0	6.36	6.4	411	409	0	2	9031	9013	2	31500	536	0.9997781475318913	0.22247179917557328	exomes
truth_sample_rank	syndip	VQSR	True	1286	22.0	6.32	6.36	410	408	0	2	9441	9421	2	31092	536	0.9997877533694153	0.23254264063387062	exomes
truth_sample_rank	syndip	VQSR	True	1290	23.0	6.29	6.32	411	409	0	2	9852	9830	2	30683	536	0.9997965825874695	0.24263816552711476	exomes
truth_sample_rank	syndip	VQSR	True	1294	24.0	6.25	6.29	410	406	0	4	10262	10236	2	30277	536	0.9998046493455753	0.2526596401155185	exomes
truth_sample_rank	syndip	VQSR	True	1298	25.0	6.22	6.25	411	409	0	2	10673	10645	2	29868	536	0.9998121536583076	0.2627551650087626	exomes
truth_sample_rank	syndip	VQSR	True	1302	26.0	6.18	6.22	410	408	0	2	11083	11053	2	29460	536	0.9998190863862506	0.27282600646705996	exomes
truth_sample_rank	syndip	VQSR	True	1306	27.0	6.15	6.18	411	410	0	1	11494	11463	2	29050	536	0.9998255560401221	0.2829462147952509	exomes
truth_sample_rank	syndip	VQSR	True	1310	28.0	6.12	6.15	410	409	0	1	11904	11872	2	28641	536	0.9998315647633484	0.29304173968849506	exomes
truth_sample_rank	syndip	VQSR	True	1314	29.0	6.09	6.12	411	410	0	1	12315	12282	2	28231	536	0.9998371865841745	0.303161948016686	exomes
truth_sample_rank	syndip	VQSR	True	1318	30.0	6.06	6.09	410	408	0	2	12725	12690	2	27823	536	0.9998424204223133	0.31323278947498334	exomes
truth_sample_rank	syndip	VQSR	True	1322	31.0	6.03	6.06	411	411	0	0	13136	13101	2	27412	536	0.9998473631992674	0.3233776812381211	exomes
truth_sample_rank	syndip	VQSR	True	1326	32.0	6.0	6.03	410	407	0	3	13546	13508	2	27005	536	0.9998519615099926	0.3334238392614716	exomes
truth_sample_rank	syndip	VQSR	True	1330	33.0	5.97	6.0	411	409	0	2	13957	13917	2	26596	536	0.9998563115166319	0.3435193641547158	exomes
truth_sample_rank	syndip	VQSR	True	1334	34.0	5.95	5.97	410	407	0	3	14367	14324	2	26189	536	0.9998603936897947	0.3535655221780663	exomes
truth_sample_rank	syndip	VQSR	True	1338	35.0	5.92	5.95	411	410	0	1	14778	14734	2	25779	536	0.9998642779587406	0.36368573050625724	exomes
truth_sample_rank	syndip	VQSR	True	1342	36.0	5.9	5.92	410	409	0	1	15188	15143	2	25370	536	0.9998679432155827	0.3737812553995014	exomes
truth_sample_rank	syndip	VQSR	True	1346	37.0	5.87	5.9	411	404	0	7	15599	15547	2	24966	536	0.9998713743649109	0.3837533631180115	exomes
truth_sample_rank	syndip	VQSR	True	1350	38.0	5.84	5.87	410	406	0	4	16009	15953	2	24560	536	0.9998746474459417	0.39377483770641525	exomes
truth_sample_rank	syndip	VQSR	True	1354	39.0	5.82	5.84	411	407	0	4	16420	16360	2	24153	536	0.9998777655543332	0.40382099572976576	exomes
truth_sample_rank	syndip	VQSR	True	1358	40.0	5.79	5.82	410	407	0	3	16830	16767	2	23746	536	0.9998807323036556	0.4138671537531163	exomes
truth_sample_rank	syndip	VQSR	True	1362	41.0	5.76	5.79	411	409	0	2	17241	17176	2	23337	536	0.9998835720107114	0.42396267864636045	exomes
truth_sample_rank	syndip	VQSR	True	1366	42.0	5.73	5.76	410	408	0	2	17651	17584	2	22929	536	0.9998862731718412	0.4340335201046578	exomes
truth_sample_rank	syndip	VQSR	True	1370	43.0	5.71	5.73	411	405	1	5	18062	17989	3	22524	535	0.9998332592263228	0.44403031125811465	exomes
truth_sample_rank	syndip	VQSR	True	1374	44.0	5.68	5.71	410	406	3	1	18472	18395	6	22118	532	0.9996739307646324	0.4540517858465184	exomes
truth_sample_rank	syndip	VQSR	True	1378	45.0	5.65	5.68	411	408	0	3	18883	18803	6	21710	532	0.9996810037747886	0.46412262730481574	exomes
truth_sample_rank	syndip	VQSR	True	1382	46.0	5.62	5.65	410	404	0	6	19293	19207	6	21306	532	0.9996877114453755	0.47409473502332583	exomes
truth_sample_rank	syndip	VQSR	True	1386	47.0	5.59	5.62	411	406	0	5	19704	19613	6	20900	532	0.9996941740149855	0.4841162096117296	exomes
truth_sample_rank	syndip	VQSR	True	1390	48.0	5.56	5.59	410	408	0	2	20114	20021	6	20492	532	0.9997004044539871	0.4941870510700269	exomes
truth_sample_rank	syndip	VQSR	True	1394	49.0	5.53	5.56	411	403	0	8	20525	20424	6	20089	532	0.9997063142437592	0.5041344753535902	exomes
truth_sample_rank	syndip	VQSR	True	1398	50.0	5.49	5.53	411	405	0	6	20936	20829	6	19684	532	0.999712023038157	0.5141312665070471	exomes
truth_sample_rank	syndip	VQSR	True	1402	51.0	5.46	5.49	410	407	0	3	21346	21236	6	19277	532	0.9997175407212127	0.5241774245303976	exomes
truth_sample_rank	syndip	VQSR	True	1406	52.0	5.42	5.46	411	406	0	5	21757	21642	6	18871	532	0.9997228381374723	0.5341988991188014	exomes
truth_sample_rank	syndip	VQSR	True	1410	53.0	5.39	5.42	410	404	1	5	22167	22046	7	18467	531	0.999682582868544	0.5441710068373115	exomes
truth_sample_rank	syndip	VQSR	True	1414	54.0	5.36	5.39	411	406	0	5	22578	22452	7	18061	531	0.9996883209403803	0.5541924814257152	exomes
truth_sample_rank	syndip	VQSR	True	1418	55.0	5.31	5.36	410	405	0	5	22988	22857	7	17656	531	0.9996938418474458	0.5641892725791721	exomes
truth_sample_rank	syndip	VQSR	True	1422	56.0	5.27	5.31	411	408	0	3	23399	23265	7	17248	531	0.9996992093502922	0.5742601140374695	exomes
truth_sample_rank	syndip	VQSR	True	1426	57.0	5.24	5.27	410	404	0	6	23809	23669	7	16844	531	0.9997043419496536	0.5842322217559796	exomes
truth_sample_rank	syndip	VQSR	True	1430	58.0	5.19	5.24	411	410	0	1	24220	24079	7	16434	531	0.9997093747405131	0.5943524300841705	exomes
truth_sample_rank	syndip	VQSR	True	1434	59.0	5.15	5.19	410	400	0	10	24630	24479	7	16034	531	0.9997141223556318	0.6042258040628934	exomes
truth_sample_rank	syndip	VQSR	True	1438	60.0	5.11	5.15	411	404	0	7	25041	24883	7	15630	531	0.9997187625552431	0.6141979117814035	exomes
truth_sample_rank	syndip	VQSR	True	1442	61.0	5.06	5.11	410	407	0	3	25451	25290	7	15223	531	0.9997232873463257	0.624244069804754	exomes
truth_sample_rank	syndip	VQSR	True	1446	62.0	5.01	5.06	411	407	0	4	25862	25697	7	14816	531	0.9997276688453159	0.6342902278281045	exomes
truth_sample_rank	syndip	VQSR	True	1450	63.0	4.96	5.01	410	408	0	2	26272	26105	7	14408	531	0.9997319240196079	0.6443610692864019	exomes
truth_sample_rank	syndip	VQSR	True	1454	64.0	4.91	4.96	411	401	0	10	26683	26506	7	14007	531	0.9997359785765474	0.6542591267000716	exomes
truth_sample_rank	syndip	VQSR	True	1458	65.0	4.85	4.91	410	402	1	7	27093	26908	8	13605	530	0.9997027790161985	0.664181867548688	exomes
truth_sample_rank	syndip	VQSR	True	1462	66.0	4.79	4.85	411	398	1	12	27504	27306	9	13207	529	0.999670510708402	0.6740058746575174	exomes
truth_sample_rank	syndip	VQSR	True	1466	67.0	4.72	4.79	410	401	0	9	27914	27707	9	12806	529	0.9996752778178669	0.683903932071187	exomes
truth_sample_rank	syndip	VQSR	True	1470	68.0	4.66	4.72	411	402	0	9	28325	28109	9	12404	529	0.9996799203357281	0.6938266729198035	exomes
truth_sample_rank	syndip	VQSR	True	1474	69.0	4.59	4.66	410	401	0	9	28735	28510	9	12003	529	0.9996844209123742	0.7037247303334732	exomes
truth_sample_rank	syndip	VQSR	True	1478	70.0	4.51	4.59	411	403	1	7	29146	28913	10	11600	528	0.9996542543996128	0.7136721546170365	exomes
truth_sample_rank	syndip	VQSR	True	1482	71.0	4.44	4.51	410	397	1	12	29556	29310	11	11203	527	0.9996248422632243	0.723471478290919	exomes
truth_sample_rank	syndip	VQSR	True	1486	72.0	4.35	4.43	411	396	1	14	29967	29706	12	10807	526	0.9995962043206138	0.7332461185298547	exomes
truth_sample_rank	syndip	VQSR	True	1490	73.0	4.25	4.35	410	394	0	16	30377	30100	12	10413	526	0.9996014877789585	0.7429713918988966	exomes
truth_sample_rank	syndip	VQSR	True	1494	74.0	4.16	4.25	411	396	1	14	30788	30496	13	10017	525	0.9995738962273427	0.7527460321378323	exomes
truth_sample_rank	syndip	VQSR	True	1498	75.0	4.07	4.16	410	398	1	11	31198	30894	14	9619	524	0.999547042836806	0.7625700392466616	exomes
truth_sample_rank	syndip	VQSR	True	1502	76.0	3.97	4.07	411	390	0	21	31609	31284	14	9229	524	0.9995526870726564	0.7721965788759164	exomes
truth_sample_rank	syndip	VQSR	True	1506	77.0	3.88	3.97	410	399	0	11	32019	31683	14	8830	524	0.9995583178218759	0.7820452694196924	exomes
truth_sample_rank	syndip	VQSR	True	1510	78.0	3.77	3.88	411	391	1	19	32430	32074	15	8439	523	0.9995325500950482	0.7916964924838941	exomes
truth_sample_rank	syndip	VQSR	True	1514	79.0	3.66	3.77	410	395	0	15	32840	32469	15	8044	523	0.9995382342076099	0.8014464492878829	exomes
truth_sample_rank	syndip	VQSR	True	1518	80.0	3.55	3.66	411	391	0	20	33251	32860	15	7653	523	0.9995437262357414	0.8110976723520845	exomes
truth_sample_rank	syndip	VQSR	True	1522	81.0	3.43	3.55	410	388	2	20	33661	33248	17	7265	521	0.9994889523523223	0.8206748451114457	exomes
truth_sample_rank	syndip	VQSR	True	1526	82.0	3.32	3.43	411	381	1	29	34072	33629	18	6884	520	0.9994650340297798	0.8300792338261792	exomes
truth_sample_rank	syndip	VQSR	True	1530	83.0	3.19	3.32	410	383	0	27	34482	34012	18	6501	520	0.9994710549515133	0.8395329894108065	exomes
truth_sample_rank	syndip	VQSR	True	1534	84.0	3.07	3.19	411	380	0	31	34893	34392	18	6121	520	0.9994768962510898	0.8489126946905932	exomes
truth_sample_rank	syndip	VQSR	True	1538	85.0	2.97	3.07	410	370	1	39	35303	34762	19	5751	519	0.999453724734769	0.8580455656209118	exomes
truth_sample_rank	syndip	VQSR	True	1542	86.0	2.85	2.96	411	379	1	31	35714	35141	20	5372	518	0.9994311879639373	0.8674005874657518	exomes
truth_sample_rank	syndip	VQSR	True	1546	87.0	2.72	2.85	410	359	0	51	36124	35500	20	5013	518	0.9994369369369369	0.8762619406116555	exomes
truth_sample_rank	syndip	VQSR	True	1550	88.0	2.57	2.72	411	364	1	46	36535	35864	21	4649	517	0.9994147972690539	0.8852467109322933	exomes
truth_sample_rank	syndip	VQSR	True	1554	89.0	2.41	2.56	410	357	1	52	36945	36221	22	4292	516	0.999392986231824	0.8940586972083036	exomes
truth_sample_rank	syndip	VQSR	True	1558	90.0	2.21	2.41	411	326	0	85	37356	36547	22	3966	516	0.9993983975498373	0.9021054970009627	exomes
truth_sample_rank	syndip	VQSR	True	1562	91.0	2.01	2.21	410	320	5	85	37766	36867	27	3646	511	0.9992681736867783	0.9100041961839409	exomes
truth_sample_rank	syndip	VQSR	True	1566	92.0	1.81	2.01	411	314	1	96	38177	37181	28	3332	510	0.9992474938858878	0.9177547947572384	exomes
truth_sample_rank	syndip	VQSR	True	1570	93.0	1.59	1.81	410	316	2	92	38587	37497	30	3016	508	0.9992005755855784	0.9255547602004295	exomes
truth_sample_rank	syndip	VQSR	True	1574	94.0	1.36	1.59	411	316	2	93	38998	37813	32	2700	506	0.999154445765623	0.9333547256436205	exomes
truth_sample_rank	syndip	VQSR	True	1578	95.0	1.09	1.36	410	306	1	103	39408	38119	33	2394	505	0.9991350387921997	0.9409078567373436	exomes
truth_sample_rank	syndip	VQSR	True	1582	96.0	0.679	1.09	411	291	5	115	39819	38410	38	2103	500	0.9990116521015397	0.9480907363068645	exomes
truth_sample_rank	syndip	VQSR	True	1586	97.0	-0.6418	0.675	410	272	41	97	40229	38682	79	1831	459	0.9979618688888315	0.9548046306123961	exomes
truth_sample_rank	syndip	VQSR	True	1590	98.0	-15.34	-0.6491	411	184	187	40	40640	38866	266	1647	272	0.9932024941224573	0.9593463826426085	exomes
truth_sample_rank	syndip	VQSR	True	1594	99.0	-1134.0	-15.34	410	27	272	111	41050	38893	538	1620	0	0.9863559128604398	0.9600128353861723	exomes
truth_sample_rank	syndip	VQSR	True	1598	100.0	-1.0	-1.0	1	0	0	1	41051	38893	538	1620	0	0.9863559128604398	0.9600128353861723	exomes
global_rank	NA12878	RF	False	0	0.0	0.9615335854860718	0.9617872044416576	32963	32866	92	5	32963	32866	92	214921	6121	0.9972085684810972	0.1326381125724917	genomes
global_rank	NA12878	RF	False	4	1.0	0.9606646027222919	0.9614095443591661	61496	61082	409	5	94459	93948	501	153839	5712	0.9946955499793539	0.379148220043828	genomes
global_rank	NA12878	RF	False	8	2.0	0.9575525460719533	0.9606646027222919	17363	17243	117	3	111822	111191	618	136596	5595	0.9944727168653686	0.4487362129570962	genomes
global_rank	NA12878	RF	False	12	3.0	0.9566835633081735	0.9575525460719533	4704	4667	36	1	116526	115858	654	131929	5559	0.9943868442735512	0.4675709379426685	genomes
global_rank	NA12878	RF	False	16	4.0	0.9517161674658469	0.9566835633081735	2444	2378	64	2	118970	118236	718	129551	5495	0.9939640533315399	0.47716789016372935	genomes
global_rank	NA12878	RF	False	20	5.0	0.9489055265431177	0.9517026107809463	1002	977	24	1	119972	119213	742	128574	5471	0.9938143470468093	0.48111079273731067	genomes
global_rank	NA12878	RF	False	24	6.0	0.9473574679692369	0.9488925188579131	256	251	5	0	120228	119464	747	128323	5466	0.9937859264127243	0.4821237595192645	genomes
global_rank	NA12878	RF	False	28	7.0	0.9430659029800459	0.9473489765505096	11534	11389	143	2	131762	130853	890	116934	5323	0.9932444228535862	0.5280866227848918	genomes
global_rank	NA12878	RF	False	32	8.0	0.938848611334415	0.9429730950731704	1257	1233	24	0	133019	132086	914	115701	5299	0.9931278195488722	0.5330626707615815	genomes
global_rank	NA12878	RF	False	36	9.0	0.9328163293188892	0.938848611334415	606	586	17	3	133625	132672	931	115115	5282	0.99303159360194	0.5354276051608842	genomes
global_rank	NA12878	RF	False	40	10.0	0.9319359377705994	0.9328163293188892	9566	9455	103	8	143191	142127	1034	105660	5179	0.9927773625498565	0.5735853777639667	genomes
global_rank	NA12878	RF	False	44	11.0	0.9302727524052729	0.9319359377705994	10060	9954	97	9	153251	152081	1131	95706	5082	0.9926180716915124	0.6137569767582641	genomes
global_rank	NA12878	RF	False	48	12.0	0.9289403700760861	0.9302727524052729	12949	12808	134	7	166200	164889	1265	82898	4948	0.992386581123536	0.6654465327075271	genomes
global_rank	NA12878	RF	False	52	13.0	0.9274463974131624	0.9289403700760861	8059	7927	130	2	174259	172816	1395	74971	4818	0.9919924689026526	0.6974377186858067	genomes
global_rank	NA12878	RF	False	56	14.0	0.9256883475114004	0.927446373147393	7545	7441	102	2	181804	180257	1497	67530	4716	0.9917635925481695	0.7274675426878731	genomes
global_rank	NA12878	RF	False	60	15.0	0.9235304009598956	0.9256716634541369	2802	2744	50	8	184606	183001	1547	64786	4666	0.9916173570019724	0.7385415699774402	genomes
global_rank	NA12878	RF	False	64	16.0	0.9209632647915988	0.923513313155762	1273	1239	32	2	185879	184240	1579	63547	4634	0.9915024835996319	0.7435418322995153	genomes
global_rank	NA12878	RF	False	68	17.0	0.9184482859124383	0.92095800271027	9315	9213	94	8	195194	193453	1673	54334	4540	0.9914260529094021	0.780722959638722	genomes
global_rank	NA12878	RF	False	72	18.0	0.9153587086194842	0.9184440853567767	5775	5698	75	2	200969	199151	1748	48636	4465	0.9912991104983101	0.8037185163063437	genomes
global_rank	NA12878	RF	False	76	19.0	0.910203331469793	0.9153389271775313	2990	2916	67	7	203959	202067	1815	45720	4398	0.9910977918599975	0.8154866881636244	genomes
global_rank	NA12878	RF	False	80	20.0	0.9038969063501853	0.9101974860373637	5469	5339	125	5	209428	207406	1940	40381	4273	0.9907330448157595	0.837033419832356	genomes
global_rank	NA12878	RF	False	84	21.0	0.893247287219882	0.903889146645562	1984	1926	56	2	211412	209332	1996	38455	4217	0.9905549666868565	0.8448062247010537	genomes
global_rank	NA12878	RF	False	88	22.0	0.8868314668671974	0.8932217475465745	878	851	26	1	212290	210183	2022	37604	4191	0.9904714780518838	0.8482406260215427	genomes
global_rank	NA12878	RF	False	92	23.0	0.8820925111558817	0.8868314668671974	645	612	28	5	212935	210795	2050	36992	4163	0.9903685780732457	0.8507104892508485	genomes
global_rank	NA12878	RF	False	96	24.0	0.8735068372297706	0.8820649795230499	1589	1543	45	1	214524	212338	2095	35449	4118	0.9902300485466323	0.8569376117391146	genomes
global_rank	NA12878	RF	False	100	25.0	0.8672636782243401	0.8734317834784006	662	634	25	3	215186	212972	2120	34815	4093	0.990143752440816	0.8594962609015001	genomes
global_rank	NA12878	RF	False	104	26.0	0.8611632298287463	0.8672121153438266	654	625	25	4	215840	213597	2145	34190	4068	0.9900575687626888	0.8620185885458075	genomes
global_rank	NA12878	RF	False	108	27.0	0.8533584611914469	0.8611183290479412	447	420	26	1	216287	214017	2171	33770	4042	0.9899578144947916	0.863713592722782	genomes
global_rank	NA12878	RF	False	112	28.0	0.8467843719035253	0.8532264490795555	283	269	12	2	216570	214286	2183	33501	4030	0.9899154151402741	0.8647992025408919	genomes
global_rank	NA12878	RF	False	116	29.0	0.841673628453896	0.8467126640799538	5078	4980	91	7	221648	219266	2274	28521	3939	0.9897354879480004	0.8848971092107334	genomes
global_rank	NA12878	RF	False	120	30.0	0.8359977366045146	0.8416522378241957	718	682	33	3	222366	219948	2307	27839	3906	0.9896200310454208	0.8876494731362017	genomes
global_rank	NA12878	RF	False	124	31.0	0.8321991882849413	0.8359977366045146	1780	1702	71	7	224146	221650	2378	26137	3835	0.9893852554145017	0.8945182757771796	genomes
global_rank	NA12878	RF	False	128	32.0	0.8283403196702026	0.8321983764515781	1038	987	43	8	225184	222637	2421	25150	3792	0.9892427729740778	0.8985015355930699	genomes
global_rank	NA12878	RF	False	132	33.0	0.8238921246659564	0.8283340377721576	485	460	19	6	225669	223097	2440	24690	3773	0.989181376004824	0.9003579687392801	genomes
global_rank	NA12878	RF	False	136	34.0	0.8191230116038576	0.8238573067310206	2052	1989	57	6	227721	225086	2497	22701	3716	0.9890281787303973	0.908385024234524	genomes
global_rank	NA12878	RF	False	140	35.0	0.8134125583603231	0.8190961577680544	971	947	24	0	228692	226033	2521	21754	3692	0.9889697839460259	0.9122068550811786	genomes
global_rank	NA12878	RF	False	144	36.0	0.8079608012229773	0.813381996388551	997	955	40	2	229689	226988	2561	20799	3652	0.9888433406375109	0.9160609717216803	genomes
global_rank	NA12878	RF	False	148	37.0	0.8031697250273827	0.8078960136879099	724	689	31	4	230413	227677	2592	20110	3621	0.9887435998766659	0.9188415857167648	genomes
global_rank	NA12878	RF	False	152	38.0	0.7976651451097811	0.8031271970851006	474	451	18	5	230887	228128	2610	19659	3603	0.988688469172828	0.920661697344897	genomes
global_rank	NA12878	RF	False	156	39.0	0.7917542678716212	0.7976256970401258	310	285	22	3	231197	228413	2632	19374	3581	0.9886082797723387	0.9218118787507013	genomes
global_rank	NA12878	RF	False	160	40.0	0.7864227162817128	0.7917142663556662	387	370	15	2	231584	228783	2647	19004	3566	0.988562416281381	0.9233050967161311	genomes
global_rank	NA12878	RF	False	164	41.0	0.7812184508277966	0.7864009843651375	794	749	45	0	232378	229532	2692	18255	3521	0.988407744246934	0.9263278541650692	genomes
global_rank	NA12878	RF	False	168	42.0	0.7775417448909262	0.7811894246045397	884	854	30	0	233262	230386	2722	17401	3491	0.9883230090773375	0.9297743626582509	genomes
global_rank	NA12878	RF	False	172	43.0	0.7723445216645392	0.7774872661005648	768	742	23	3	234030	231128	2745	16659	3468	0.9882628606123837	0.9327688700375726	genomes
global_rank	NA12878	RF	False	176	44.0	0.7662954585191935	0.7722858661109447	572	538	29	5	234602	231666	2774	16121	3439	0.9881675481999659	0.9349400896737924	genomes
global_rank	NA12878	RF	False	180	45.0	0.7621123021152337	0.7662786365674026	1089	1038	49	2	235691	232704	2823	15083	3390	0.9880141130316269	0.9391291714254582	genomes
global_rank	NA12878	RF	False	184	46.0	0.7579044217577965	0.7620697402850518	318	295	21	2	236009	232999	2844	14788	3369	0.9879411303282268	0.9403197100735713	genomes
global_rank	NA12878	RF	False	188	47.0	0.7506627912291054	0.7578901436223126	468	445	23	0	236477	233444	2867	14343	3346	0.987867682841679	0.9421156073563182	genomes
global_rank	NA12878	RF	False	192	48.0	0.7444116405583344	0.7506495113293071	1338	1293	42	3	237815	234737	2909	13050	3304	0.9877591038771955	0.9473337987868613	genomes
global_rank	NA12878	RF	False	196	49.0	0.7365266122487921	0.7443933914287487	1149	1114	29	6	238964	235851	2938	11936	3275	0.9876962506648128	0.9518295955800748	genomes
global_rank	NA12878	RF	False	200	50.0	0.7291188128970153	0.736514527161525	619	596	22	1	239583	236447	2960	11340	3253	0.9876361175738387	0.9542348872216864	genomes
global_rank	NA12878	RF	False	204	51.0	0.719031508567939	0.729070234844817	457	428	25	4	240040	236875	2985	10912	3228	0.9875552405569916	0.9559621771925081	genomes
global_rank	NA12878	RF	False	208	52.0	0.7115199859573963	0.7188589387994817	379	340	36	3	240419	237215	3021	10572	3192	0.987424865548877	0.9573343234310113	genomes
global_rank	NA12878	RF	False	212	53.0	0.7031570616680607	0.7114342609905419	845	823	19	3	241264	238038	3040	9749	3173	0.9873899733696148	0.9606557244730353	genomes
global_rank	NA12878	RF	False	216	54.0	0.694783793266918	0.7031055095058726	727	690	32	5	241991	238728	3072	9059	3141	0.9872952853598015	0.9634403741923507	genomes
global_rank	NA12878	RF	False	220	55.0	0.6836435341246018	0.6947729838735882	573	545	24	4	242564	239273	3096	8514	3117	0.9872260891450639	0.9656398438981868	genomes
global_rank	NA12878	RF	False	224	56.0	0.6721902316461527	0.6835672509976166	239	222	16	1	242803	239495	3112	8292	3101	0.9871726702032505	0.9665357746774448	genomes
global_rank	NA12878	RF	False	228	57.0	0.6613979340819421	0.6721437565307243	178	163	13	2	242981	239658	3125	8129	3088	0.9871284233245327	0.9671935977270801	genomes
global_rank	NA12878	RF	False	232	58.0	0.6502348620080095	0.6613867792950289	150	133	13	4	243131	239791	3138	7996	3075	0.9870826455466412	0.9677303490497887	genomes
global_rank	NA12878	RF	False	236	59.0	0.6378770522599801	0.6498360614979217	143	130	11	2	243274	239921	3149	7866	3064	0.9870448841897396	0.9682549931998047	genomes
global_rank	NA12878	RF	False	240	60.0	0.6275446672111908	0.6377754583382121	199	184	12	3	243473	240105	3161	7682	3052	0.9870059934392804	0.9689975664582887	genomes
global_rank	NA12878	RF	False	244	61.0	0.6168627892650078	0.627437558363718	526	484	38	4	243999	240589	3199	7198	3014	0.986877943130917	0.9709508569860404	genomes
global_rank	NA12878	RF	False	248	62.0	0.6071501979995094	0.6168531104387405	1183	1131	44	8	245182	241720	3243	6067	2970	0.9867612659871082	0.9755152610911791	genomes
global_rank	NA12878	RF	False	252	63.0	0.5972600205329095	0.6070773229022713	1128	997	123	8	246310	242717	3366	5070	2847	0.9863216882108882	0.9795388781493783	genomes
global_rank	NA12878	RF	False	256	64.0	0.5860543315085127	0.5970867935168014	180	146	34	0	246490	242863	3400	4924	2813	0.9861936222656266	0.9801280938870885	genomes
global_rank	NA12878	RF	False	260	65.0	0.5709082178682384	0.5857777101145066	220	192	26	2	246710	243055	3426	4732	2787	0.9861003485055643	0.9809029529394198	genomes
global_rank	NA12878	RF	False	264	66.0	0.5524927211693789	0.5699665910058477	182	160	19	3	246892	243215	3445	4572	2768	0.9860334063082786	0.9815486688163625	genomes
global_rank	NA12878	RF	False	268	67.0	0.5333985291113593	0.5524495140812267	230	179	49	2	247122	243394	3494	4393	2719	0.9858478338355854	0.9822710634536921	genomes
global_rank	NA12878	RF	False	272	68.0	0.5152661587137608	0.5327230112920188	65	44	16	5	247187	243438	3510	4349	2703	0.9857864813644978	0.9824486353198513	genomes
global_rank	NA12878	RF	False	276	69.0	0.4992492148581957	0.5150549459792386	216	189	20	7	247403	243627	3530	4160	2683	0.9857175803234381	0.9832113871994899	genomes
global_rank	NA12878	RF	False	280	70.0	0.48066465374044975	0.4987575756495243	137	107	27	3	247540	243734	3557	4053	2656	0.9856161364546223	0.9836432096921953	genomes
global_rank	NA12878	RF	False	284	71.0	0.4607425071848365	0.4804634483759856	76	55	18	3	247616	243789	3575	3998	2638	0.9855476140424637	0.9838651745248944	genomes
global_rank	NA12878	RF	False	288	72.0	0.43615538445422586	0.45989194312078857	65	48	14	3	247681	243837	3589	3950	2624	0.9854946529467397	0.9840588892879771	genomes
global_rank	NA12878	RF	False	292	73.0	0.40711942847331206	0.4358219625653682	102	79	18	5	247783	243916	3607	3871	2606	0.9854276168275271	0.9843777115022176	genomes
global_rank	NA12878	RF	False	296	74.0	0.3767155361062944	0.4064240676651598	88	68	17	3	247871	243984	3624	3803	2589	0.9853639623921683	0.9846521407499182	genomes
global_rank	NA12878	RF	False	300	75.0	0.34705686244071277	0.37611982215050915	80	58	18	4	247951	244042	3642	3745	2571	0.9852957801069104	0.98488621275531	genomes
global_rank	NA12878	RF	False	304	76.0	0.3113575565771153	0.34637304412343245	96	64	29	3	248047	244106	3671	3681	2542	0.9851842584259233	0.985144499106087	genomes
global_rank	NA12878	RF	False	308	77.0	0.2716791585399404	0.310681277633131	75	43	32	0	248122	244149	3703	3638	2510	0.9850596323612478	0.9853180352480154	genomes
global_rank	NA12878	RF	False	312	78.0	0.24213582517863716	0.2711784902300368	62	36	21	5	248184	244185	3724	3602	2489	0.984978358994631	0.9854633213203275	genomes
global_rank	NA12878	RF	False	316	79.0	0.22273743145681565	0.2413642845492422	45	28	15	2	248229	244213	3739	3574	2474	0.9849204684777699	0.9855763215987925	genomes
global_rank	NA12878	RF	False	320	80.0	0.20635130385833675	0.22183053950454745	71	40	30	1	248300	244253	3769	3534	2444	0.98480376740773	0.9857377505680281	genomes
global_rank	NA12878	RF	False	324	81.0	0.19378031601906265	0.20591679352628836	68	35	28	5	248368	244288	3797	3499	2416	0.9846947618759699	0.9858790009161094	genomes
global_rank	NA12878	RF	False	328	82.0	0.17643139834947863	0.19306816033155064	85	52	30	3	248453	244340	3827	3447	2386	0.9845789327348117	0.9860888585761157	genomes
global_rank	NA12878	RF	False	332	83.0	0.1598155955794223	0.1757647519099023	69	48	19	2	248522	244388	3846	3399	2367	0.9845065542995721	0.9862825733391986	genomes
global_rank	NA12878	RF	False	336	84.0	0.14518478369989912	0.15947874816673285	83	59	19	5	248605	244447	3865	3340	2348	0.9844349044750152	0.9865206810688212	genomes
global_rank	NA12878	RF	False	340	85.0	0.1296908159946675	0.14502330573485664	68	36	27	5	248673	244483	3892	3304	2321	0.9843301459486663	0.9866659671411333	genomes
global_rank	NA12878	RF	False	344	86.0	0.11455370756834989	0.12928697830486438	72	32	38	2	248745	244515	3930	3272	2283	0.9841816096117854	0.9867951103165219	genomes
global_rank	NA12878	RF	False	348	87.0	0.0961594744828305	0.11363956365209396	69	23	45	1	248814	244538	3975	3249	2238	0.9840048609127088	0.9868879319738324	genomes
global_rank	NA12878	RF	False	352	88.0	0.0789591780225416	0.09574873651191736	80	14	63	3	248894	244552	4038	3235	2175	0.9837563860171367	0.9869444321130648	genomes
global_rank	NA12878	RF	False	356	89.0	0.06230852430935187	0.0787487502746825	94	18	74	2	248988	244570	4112	3217	2101	0.9834648265656541	0.9870170751492209	genomes
global_rank	NA12878	RF	False	360	90.0	0.04706720264803591	0.06215230663156874	135	10	124	1	249123	244580	4236	3207	1977	0.982975371358755	0.9870574323915299	genomes
global_rank	NA12878	RF	False	364	91.0	0.036064211742537815	0.04667395947079842	104	6	95	3	249227	244586	4331	3201	1882	0.9826006259114484	0.9870816467369151	genomes
global_rank	NA12878	RF	False	368	92.0	0.026989171831263047	0.036014272569724344	117	4	113	0	249344	244590	4444	3197	1769	0.9821550471020022	0.9870977896338388	genomes
global_rank	NA12878	RF	False	372	93.0	0.02080580078445072	0.026910817682218584	181	1	180	0	249525	244591	4624	3196	1589	0.9814457396224143	0.9871018253580697	genomes
global_rank	NA12878	RF	False	376	94.0	0.014601013114612609	0.02040420766777144	197	0	197	0	249722	244591	4821	3196	1392	0.9806705371032669	0.9871018253580697	genomes
global_rank	NA12878	RF	False	380	95.0	0.01061970495179106	0.014538221077462965	207	0	207	0	249929	244591	5028	3196	1185	0.9798573025290542	0.9871018253580697	genomes
global_rank	NA12878	RF	False	384	96.0	0.007769861258184221	0.010590453779429616	155	0	155	0	250084	244591	5183	3196	1030	0.979249241314148	0.9871018253580697	genomes
global_rank	NA12878	RF	False	388	97.0	0.005998671015536303	0.007751291588755902	257	1	256	0	250341	244592	5439	3195	774	0.9782466974095212	0.9871058610823005	genomes
global_rank	NA12878	RF	False	392	98.0	0.004316881868152928	0.005980449889578846	200	0	200	0	250541	244592	5639	3195	574	0.9774648225040063	0.9871058610823005	genomes
global_rank	NA12878	RF	False	396	99.0	0.0014916482210623925	0.004309980648090634	576	1	574	1	251117	244593	6213	3194	0	0.9752278653620727	0.9871098968065314	genomes
global_rank	NA12878	RF	False	400	-1.0	-1.0	-1.0	2883	0	0	2883	254000	244593	6213	3194	0	0.9752278653620727	0.9871098968065314	genomes
global_rank	NA12878	RF	True	404	0.0	0.9719609898644941	0.9719609898644941	320836	320798	27	11	320836	320798	27	2794027	30177	0.9999158419699213	0.10299069771174946	genomes
global_rank	NA12878	RF	True	408	1.0	0.9719609898644941	0.9719609898644941	312973	312862	44	67	633809	633660	71	2481165	30133	0.9998879650829768	0.20343357973561918	genomes
global_rank	NA12878	RF	True	412	2.0	0.9719609898644941	0.9719609898644941	315969	315914	41	14	949778	949574	112	2165251	30092	0.999882066282961	0.3048562920870354	genomes
global_rank	NA12878	RF	True	416	3.0	0.9719609898644941	0.9719609898644941	315814	315770	36	8	1265592	1265344	148	1849481	30056	0.9998830494384793	0.406232773911857	genomes
global_rank	NA12878	RF	True	420	4.0	0.9719609898644941	0.9719609898644941	320518	320474	39	5	1586110	1585818	187	1529007	30017	0.9998820936882292	0.5091194529387686	genomes
global_rank	NA12878	RF	True	424	5.0	0.9715833297820027	0.9719609898644941	685113	684840	237	36	2271223	2270658	424	844167	29780	0.9998133048476453	0.7289841323348824	genomes
global_rank	NA12878	RF	True	428	6.0	0.9707170463107051	0.9715833297820027	276079	275991	66	22	2547302	2546649	490	568176	29714	0.9998076273026325	0.8175897522332716	genomes
global_rank	NA12878	RF	True	432	7.0	0.9707170463107051	0.9707170463107051	35863	35848	12	3	2583165	2582497	502	532328	29702	0.9998056522669966	0.8290985849927364	genomes
global_rank	NA12878	RF	True	436	8.0	0.9707170463107051	0.9707170463107051	34609	34596	9	4	2617774	2617093	511	497732	29693	0.999804783305649	0.840205469007087	genomes
global_rank	NA12878	RF	True	440	9.0	0.9707170463107051	0.9707170463107051	34304	34290	11	3	2652078	2651383	522	463442	29682	0.9998031603696211	0.8512141131524243	genomes
global_rank	NA12878	RF	True	444	10.0	0.9704465277076896	0.9707170463107051	55124	55080	34	10	2707202	2706463	556	408362	29648	0.9997946080171584	0.8688972895748557	genomes
global_rank	NA12878	RF	True	448	11.0	0.9693997886081807	0.9704465277076896	69016	68983	32	1	2776218	2775446	588	339379	29616	0.9997881870322914	0.8910439591309303	genomes
global_rank	NA12878	RF	True	452	12.0	0.9669020740964359	0.9693997886081807	18908	18888	14	6	2795126	2794334	602	320491	29602	0.9997846104526186	0.8971078632025876	genomes
global_rank	NA12878	RF	True	456	13.0	0.9666484551408503	0.9669020740964359	4751	4746	3	2	2799877	2799080	605	315745	29599	0.9997839042606579	0.8986315443082677	genomes
global_rank	NA12878	RF	True	460	14.0	0.965593294231448	0.9666484551408503	27123	27098	9	16	2827000	2826178	614	288647	29590	0.9997827926497599	0.9073312304864639	genomes
global_rank	NA12878	RF	True	464	15.0	0.965406773606043	0.965593294231448	5544	5511	20	13	2832544	2831689	634	283136	29570	0.9997761554737931	0.9091005112646778	genomes
global_rank	NA12878	RF	True	468	16.0	0.9651139194692663	0.965406773606043	13183	13165	6	12	2845727	2844854	640	269971	29564	0.999775082990862	0.9133270729495236	genomes
global_rank	NA12878	RF	True	472	17.0	0.9646135610282996	0.9651139194692663	7815	7794	15	6	2853542	2852648	655	262177	29549	0.9997704414848335	0.9158293002014559	genomes
global_rank	NA12878	RF	True	476	18.0	0.9638166155900145	0.9646135610282996	4626	4606	15	5	2858168	2857254	670	257571	29534	0.9997655640947765	0.9173080349618358	genomes
global_rank	NA12878	RF	True	480	19.0	0.9615918013917737	0.9638166155900145	4760	4751	5	4	2862928	2862005	675	252820	29529	0.9997642069668982	0.9188333212941338	genomes
global_rank	NA12878	RF	True	484	20.0	0.9610522077696162	0.9615918013917737	2274	2271	2	1	2865202	2864276	677	250549	29527	0.9997636959489388	0.9195624152239692	genomes
global_rank	NA12878	RF	True	488	21.0	0.9606639597714645	0.9610522077696162	773	772	1	0	2865975	2865048	678	249777	29526	0.9997634107378026	0.919810262213768	genomes
global_rank	NA12878	RF	True	492	22.0	0.9594803184192858	0.9606639597714645	2433	2424	3	6	2868408	2867472	681	247353	29523	0.9997625649677685	0.9205884760781103	genomes
global_rank	NA12878	RF	True	496	23.0	0.9547875170713338	0.9594803184192858	3202	3193	3	6	2871610	2870665	684	244160	29520	0.9997617844434794	0.9216135737962807	genomes
global_rank	NA12878	RF	True	500	24.0	0.9518234266298246	0.9547875170713338	6953	6905	47	1	2878563	2877570	731	237255	29473	0.9997460307313238	0.923830391755556	genomes
global_rank	NA12878	RF	True	504	25.0	0.9496183199326015	0.9518234266298246	2425	2415	8	2	2880988	2879985	739	234840	29465	0.9997434672672564	0.9246057162119862	genomes
global_rank	NA12878	RF	True	508	26.0	0.9475262140802307	0.9495952859623199	4691	4676	10	5	2885679	2884661	749	230164	29455	0.9997404181728073	0.9261069241450162	genomes
global_rank	NA12878	RF	True	512	27.0	0.9462022290922818	0.9475237960751838	3075	3067	5	3	2888754	2887728	754	227097	29450	0.9997389632339755	0.9270915701524163	genomes
global_rank	NA12878	RF	True	516	28.0	0.9433952251108542	0.9461860871458218	1622	1617	3	2	2890376	2889345	757	225480	29447	0.9997380715282713	0.9276107004406348	genomes
global_rank	NA12878	RF	True	520	29.0	0.9362258679510396	0.9433952251108542	8750	8709	35	6	2899126	2898054	792	216771	29412	0.9997267878321235	0.9304066841636368	genomes
global_rank	NA12878	RF	True	524	30.0	0.9332855045454258	0.9362258679510396	20775	20667	80	28	2919901	2918721	872	196104	29332	0.9997013282330791	0.9370417278659314	genomes
global_rank	NA12878	RF	True	528	31.0	0.9310177072368541	0.9332836315477364	5232	5201	20	11	2925133	2923922	892	190903	29312	0.9996950233416553	0.9387114845938376	genomes
global_rank	NA12878	RF	True	532	32.0	0.9288237338535816	0.9310001728189042	1266	1251	11	4	2926399	2925173	903	189652	29301	0.9996913955755079	0.939113112293628	genomes
global_rank	NA12878	RF	True	536	33.0	0.927122417238108	0.9288068091369093	730	708	17	5	2927129	2925881	920	188944	29284	0.9996856636307012	0.9393404123827181	genomes
global_rank	NA12878	RF	True	540	34.0	0.9248021274317474	0.9270916642290588	817	810	4	3	2927946	2926691	924	188134	29280	0.9996843847295495	0.9396004590948127	genomes
global_rank	NA12878	RF	True	544	35.0	0.9184679313358064	0.9247761396178177	1245	1216	25	4	2929191	2927907	949	186918	29255	0.9996759827045099	0.9399908502082781	genomes
global_rank	NA12878	RF	True	548	36.0	0.9126507891749754	0.9184614740407839	12169	12154	11	4	2941360	2940061	960	174764	29244	0.9996735827455839	0.9438928350709912	genomes
global_rank	NA12878	RF	True	552	37.0	0.9088384167969721	0.9126463951288752	4680	4669	9	2	2946040	2944730	969	170095	29235	0.9996710458196849	0.9453917956867561	genomes
global_rank	NA12878	RF	True	556	38.0	0.9029036142133262	0.9087598875972097	689	662	22	5	2946729	2945392	991	169433	29213	0.9996636554039309	0.9456043276909618	genomes
global_rank	NA12878	RF	True	560	39.0	0.8967961267743882	0.9028914082249991	753	730	18	5	2947482	2946122	1009	168703	29195	0.999657633135412	0.9458386907771704	genomes
global_rank	NA12878	RF	True	564	40.0	0.8916693897747817	0.8967112390202757	627	614	11	2	2948109	2946736	1020	168089	29184	0.9996539740738378	0.9460358126058447	genomes
global_rank	NA12878	RF	True	568	41.0	0.8889192580536899	0.8916594758027316	403	389	11	3	2948512	2947125	1031	167700	29173	0.9996502898761124	0.9461606992367148	genomes
global_rank	NA12878	RF	True	572	42.0	0.8849364930121402	0.8889079718902645	364	350	12	2	2948876	2947475	1043	167350	29161	0.9996462629700751	0.9462730650999654	genomes
global_rank	NA12878	RF	True	576	43.0	0.8815164306896486	0.8848835780839663	276	257	19	0	2949152	2947732	1062	167093	29142	0.9996398527669278	0.9463555737481238	genomes
global_rank	NA12878	RF	True	580	44.0	0.8760547195327478	0.8814477292199039	409	392	14	3	2949561	2948124	1076	166701	29128	0.9996351552963516	0.9464814235149647	genomes
global_rank	NA12878	RF	True	584	45.0	0.869115989940143	0.8760096484779568	820	793	18	9	2950381	2948917	1094	165908	29110	0.9996291539251888	0.9467360124565586	genomes
global_rank	NA12878	RF	True	588	46.0	0.8645531631191726	0.8691033632570027	407	396	8	3	2950788	2949313	1102	165512	29102	0.9996264932221399	0.9468631464046937	genomes
global_rank	NA12878	RF	True	592	47.0	0.8617979080673152	0.8645016506349343	489	481	2	6	2951277	2949794	1104	165031	29100	0.9996258765975645	0.9470175692053325	genomes
global_rank	NA12878	RF	True	596	48.0	0.8587934811816726	0.8617091619604409	6237	6213	14	10	2957514	2956007	1118	158818	29086	0.9996219300841188	0.949012223800695	genomes
global_rank	NA12878	RF	True	600	49.0	0.8564641847862497	0.8587537566351441	9378	9354	11	13	2966892	2965361	1129	149464	29075	0.9996194155382286	0.9520152817574021	genomes
global_rank	NA12878	RF	True	604	50.0	0.8542977189793948	0.8564608920238558	3766	3742	14	10	2970658	2969103	1143	145722	29061	0.9996151833888506	0.9532166333582144	genomes
global_rank	NA12878	RF	True	608	51.0	0.8519152044524864	0.8542885351945638	26655	26602	20	33	2997313	2995705	1163	119120	29041	0.9996119281863599	0.9617570810559181	genomes
global_rank	NA12878	RF	True	612	52.0	0.8497533553422173	0.851886658416599	1853	1833	6	14	2999166	2997538	1169	117287	29035	0.9996101653145839	0.9623455571340284	genomes
global_rank	NA12878	RF	True	616	53.0	0.8474455868047347	0.8497324131352129	34108	33999	63	46	3033274	3031537	1232	83288	28972	0.9995937705773172	0.9732607770902058	genomes
global_rank	NA12878	RF	True	620	54.0	0.844780830990976	0.8474366212532678	15544	15482	43	19	3048818	3047019	1275	67806	28929	0.9995817332580125	0.9782312007897715	genomes
global_rank	NA12878	RF	True	624	55.0	0.8420586179860721	0.84477421613475	3312	3299	12	1	3052130	3050318	1287	64507	28917	0.9995782547216956	0.9792903293122407	genomes
global_rank	NA12878	RF	True	628	56.0	0.8394836309842032	0.842037299143933	853	840	7	6	3052983	3051158	1294	63667	28910	0.9995760785099979	0.9795600073840425	genomes
global_rank	NA12878	RF	True	632	57.0	0.8364488138714418	0.8394755773431052	1249	1225	11	13	3054232	3052383	1305	62442	28899	0.9995726478933015	0.97995328790542	genomes
global_rank	NA12878	RF	True	636	58.0	0.8326013744154694	0.8364487442183428	2693	2646	18	29	3056925	3055029	1323	59796	28881	0.9995671310110877	0.9808027738315956	genomes
global_rank	NA12878	RF	True	640	59.0	0.8284737754402409	0.8325847036124154	1795	1772	15	8	3058720	3056801	1338	58024	28866	0.9995624790109279	0.9813716661449681	genomes
global_rank	NA12878	RF	True	644	60.0	0.8236971457060616	0.8284236821919602	2424	2393	14	17	3061144	3059194	1352	55631	28852	0.9995582487569211	0.9821399276042795	genomes
global_rank	NA12878	RF	True	648	61.0	0.8188092711982692	0.8236753958224542	4330	4303	15	12	3065474	3063497	1367	51328	28837	0.9995539769464485	0.9835213856316165	genomes
global_rank	NA12878	RF	True	652	62.0	0.8141297707713158	0.8187893830733969	2897	2849	20	28	3068371	3066346	1387	48479	28817	0.9995478746031679	0.9844360437584776	genomes
global_rank	NA12878	RF	True	656	63.0	0.8108663875265051	0.8141227739577237	1377	1333	30	14	3069748	3067679	1417	47146	28787	0.9995383005288854	0.9848639971748011	genomes
global_rank	NA12878	RF	True	660	64.0	0.8060394410646425	0.8108401937100658	1235	1201	21	13	3070983	3068880	1438	45945	28766	0.9995316446048911	0.985249572608413	genomes
global_rank	NA12878	RF	True	664	65.0	0.8018643475938343	0.8060144861618835	911	893	9	9	3071894	3069773	1447	45052	28757	0.9995288517266754	0.9855362660823642	genomes
global_rank	NA12878	RF	True	668	66.0	0.7959847301084652	0.80185515403072	955	943	6	6	3072849	3070716	1453	44109	28751	0.9995270442478913	0.985839011822494	genomes
global_rank	NA12878	RF	True	672	67.0	0.7904682696491852	0.7959360529166701	580	564	8	8	3073429	3071280	1461	43545	28743	0.9995245287513657	0.9860200813849895	genomes
global_rank	NA12878	RF	True	676	68.0	0.7843610704663257	0.7904309967126134	521	500	15	6	3073950	3071780	1476	43045	28728	0.9995197276113672	0.9861806040467763	genomes
global_rank	NA12878	RF	True	680	69.0	0.7785903833299495	0.78428849311754	847	830	8	9	3074797	3072610	1484	42215	28720	0.9995172561411589	0.9864470716653424	genomes
global_rank	NA12878	RF	True	684	70.0	0.7715298025251621	0.7785654644417713	797	770	15	12	3075594	3073380	1499	41445	28705	0.9995125011423214	0.986694276564494	genomes
global_rank	NA12878	RF	True	688	71.0	0.763234617635793	0.7714817136875761	1224	1176	30	18	3076818	3074556	1529	40269	28675	0.9995029396131772	0.9870718258650165	genomes
global_rank	NA12878	RF	True	692	72.0	0.7537134471677157	0.7632023816632252	1689	1660	9	20	3078507	3076216	1538	38609	28666	0.9995002849480498	0.9876047611021486	genomes
global_rank	NA12878	RF	True	696	73.0	0.7419567795353533	0.7536086800560958	994	964	12	18	3079501	3077180	1550	37645	28654	0.9994965456535649	0.9879142487940735	genomes
global_rank	NA12878	RF	True	700	74.0	0.7304441365873756	0.7419539461544759	2083	2044	19	20	3081584	3079224	1569	35601	28635	0.9994907155397977	0.9885704654354579	genomes
global_rank	NA12878	RF	True	704	75.0	0.721828004044095	0.730441503348042	976	938	17	21	3082560	3080162	1586	34663	28618	0.99948535701167	0.9888716059489698	genomes
global_rank	NA12878	RF	True	708	76.0	0.7088708822553553	0.7217878067790654	1492	1457	12	23	3084052	3081619	1598	33206	28606	0.9994817101747947	0.9893393689854165	genomes
global_rank	NA12878	RF	True	712	77.0	0.6881153519545594	0.7087506791899914	1026	979	23	24	3085078	3082598	1621	32227	28583	0.9994744212392181	0.989653672357195	genomes
global_rank	NA12878	RF	True	716	78.0	0.6673548249289664	0.6880856990695934	633	596	12	25	3085711	3083194	1633	31631	28571	0.9994706348200402	0.9898450153700449	genomes
global_rank	NA12878	RF	True	720	79.0	0.6494715426130048	0.6672483867435395	671	620	33	18	3086382	3083814	1666	31011	28538	0.9994600515965101	0.9900440634706604	genomes
global_rank	NA12878	RF	True	724	80.0	0.630375113307895	0.6493678060676568	550	504	33	13	3086932	3084318	1699	30507	28505	0.999449452157911	0.9902058703137415	genomes
global_rank	NA12878	RF	True	728	81.0	0.614301883096098	0.6303035204347487	1098	993	83	22	3088030	3085311	1782	29514	28422	0.9994227579149705	0.99052466832005	genomes
global_rank	NA12878	RF	True	732	82.0	0.5953282600686528	0.6142667638682995	391	319	55	17	3088421	3085630	1837	29195	28367	0.9994050138835492	0.9906270817782701	genomes
global_rank	NA12878	RF	True	736	83.0	0.5687630594883576	0.5951922749957363	628	590	22	16	3089049	3086220	1859	28605	28345	0.9993980076286908	0.9908164985191784	genomes
global_rank	NA12878	RF	True	740	84.0	0.5304914978518209	0.5687630594883576	10467	10323	79	65	3099516	3096543	1938	18282	28266	0.9993745322304703	0.9941306493944283	genomes
global_rank	NA12878	RF	True	744	85.0	0.43605480361194515	0.5304354540976571	10296	8204	1987	105	3109812	3104747	3925	10078	26279	0.99873740298108	0.9967645052290257	genomes
global_rank	NA12878	RF	True	748	86.0	0.33060987835213296	0.43601188562648596	2772	2136	570	66	3112584	3106883	4495	7942	25709	0.998555302505835	0.9974502580401788	genomes
global_rank	NA12878	RF	True	752	87.0	0.3047713626509136	0.3305465072618182	455	291	153	11	3113039	3107174	4648	7651	25556	0.9985063413010127	0.9975436822293388	genomes
global_rank	NA12878	RF	True	756	88.0	0.2826803373065885	0.3045635528946622	438	251	174	13	3113477	3107425	4822	7400	25382	0.9984506371120287	0.9976242646055556	genomes
global_rank	NA12878	RF	True	760	89.0	0.26348397283032465	0.2826520213315668	615	386	203	26	3114092	3107811	5025	7014	25179	0.998385716433503	0.9977481881004551	genomes
global_rank	NA12878	RF	True	764	90.0	0.2437356780379878	0.263457977793455	713	530	143	40	3114805	3108341	5168	6484	25036	0.9983401364826632	0.9979183421219491	genomes
global_rank	NA12878	RF	True	768	91.0	0.21487433217381302	0.24358829057054682	1201	924	197	80	3116006	3109265	5365	5560	24839	0.9982774840029153	0.998214988000931	genomes
global_rank	NA12878	RF	True	772	92.0	0.1748166407821781	0.2147517076002831	1026	706	256	64	3117032	3109971	5621	4854	24583	0.9981958484936411	0.998441645999374	genomes
global_rank	NA12878	RF	True	776	93.0	0.11460103949788888	0.17468352178598115	1292	658	561	73	3118324	3110629	6182	4196	24022	0.9980165624415468	0.9986528938222854	genomes
global_rank	NA12878	RF	True	780	94.0	0.06896537748175957	0.11456285091006009	1700	386	1270	44	3120024	3111015	7452	3810	22752	0.9976103643232396	0.9987768173171847	genomes
global_rank	NA12878	RF	True	784	95.0	0.03649302599107794	0.06893657490868024	3247	200	3015	32	3123271	3111215	10467	3610	19737	0.9966469999186336	0.9988410263818994	genomes
global_rank	NA12878	RF	True	788	96.0	0.022692628979620624	0.03649056947154182	2500	73	2415	12	3125771	3111288	12882	3537	17322	0.9958766648421821	0.9988644626905203	genomes
global_rank	NA12878	RF	True	792	97.0	0.011211154696240386	0.022664707036422496	4614	25	4578	11	3130385	3111313	17460	3512	12744	0.9944195376270506	0.9988724888236097	genomes
global_rank	NA12878	RF	True	796	98.0	0.005281708496977174	0.011210322046839253	5223	7	5213	3	3135608	3111320	22673	3505	7531	0.9927654592719256	0.9988747361408747	genomes
global_rank	NA12878	RF	True	800	99.0	0.0014067156666908416	0.005280805947963959	7540	8	7531	1	3143148	3111328	30204	3497	0	0.990385582575635	0.9988773045034632	genomes
global_rank	NA12878	RF	True	806	-1.0	-1.0	-1.0	1881	0	0	1881	3145029	3111328	30204	3497	0	0.990385582575635	0.9988773045034632	genomes
global_rank	NA12878	VQSR	False	1	0.0	7.06	93.56	87597	87316	279	2	87597	87316	279	160471	5934	0.9968148866944461	0.35238329694455317	genomes
global_rank	NA12878	VQSR	False	5	1.0	6.42	7.06	41949	41791	149	9	129546	129107	428	118680	5785	0.9966958737020882	0.5210402482777546	genomes
global_rank	NA12878	VQSR	False	9	2.0	5.72	6.42	26547	26087	455	5	156093	155194	883	92593	5330	0.9943425360559212	0.6263201862890305	genomes
global_rank	NA12878	VQSR	False	13	3.0	5.26	5.72	14315	14002	309	4	170408	169196	1192	78591	5021	0.993004202173862	0.6828283969699782	genomes
global_rank	NA12878	VQSR	False	17	4.0	4.87	5.26	8999	8786	205	8	179407	177982	1397	69805	4816	0.9922120203591279	0.718286270062594	genomes
global_rank	NA12878	VQSR	False	21	5.0	4.52	4.87	7139	6997	139	3	186546	184979	1536	62808	4677	0.9917647374205828	0.7465242325061444	genomes
global_rank	NA12878	VQSR	False	25	6.0	4.16	4.52	5888	5765	119	4	192434	190744	1655	57043	4558	0.9913980841896267	0.769790182697236	genomes
global_rank	NA12878	VQSR	False	29	7.0	3.78	4.16	4917	4783	130	4	197351	195527	1785	52260	4428	0.9909534138825818	0.7890930516935917	genomes
global_rank	NA12878	VQSR	False	33	8.0	3.42	3.78	4545	4430	110	5	201896	199957	1895	47830	4318	0.9906119334958287	0.8069713100364426	genomes
global_rank	NA12878	VQSR	False	37	9.0	3.11	3.42	4892	4753	126	13	206788	204710	2021	43077	4192	0.990224010912732	0.8261531073058715	genomes
global_rank	NA12878	VQSR	False	41	10.0	2.82	3.11	4561	4460	94	7	211349	209170	2115	38617	4098	0.9899898241711432	0.8441524373756493	genomes
global_rank	NA12878	VQSR	False	45	11.0	2.53	2.82	4188	4075	102	11	215537	213245	2217	34542	3996	0.9897104825908977	0.8605980136165335	genomes
global_rank	NA12878	VQSR	False	49	12.0	2.26	2.53	3344	3244	86	14	218881	216489	2303	31298	3910	0.9894740209879703	0.8736899030215467	genomes
global_rank	NA12878	VQSR	False	53	13.0	2.02	2.26	2679	2592	73	14	221560	219081	2376	28706	3837	0.9892710548774706	0.8841505002280184	genomes
global_rank	NA12878	VQSR	False	57	14.0	1.79	2.02	2484	2401	78	5	224044	221482	2454	26305	3759	0.9890415118605316	0.8938402741063898	genomes
global_rank	NA12878	VQSR	False	61	15.0	1.59	1.79	2187	2110	71	6	226231	223592	2525	24195	3688	0.9888332146632053	0.9023556522335716	genomes
global_rank	NA12878	VQSR	False	65	16.0	1.41	1.59	1970	1877	80	13	228201	225469	2605	22318	3608	0.9885782684567289	0.9099307066149556	genomes
global_rank	NA12878	VQSR	False	69	17.0	1.25	1.41	1672	1609	57	6	229873	227078	2662	20709	3551	0.988412988595804	0.9164241869024606	genomes
global_rank	NA12878	VQSR	False	73	18.0	1.11	1.25	1489	1432	52	5	231362	228510	2714	19277	3499	0.9882624641040723	0.9222033440010977	genomes
global_rank	NA12878	VQSR	False	77	19.0	0.981	1.11	1403	1338	51	14	232765	229848	2765	17939	3448	0.9881133040715695	0.9276031430220311	genomes
global_rank	NA12878	VQSR	False	81	20.0	0.868	0.981	1268	1226	38	4	234033	231074	2803	16713	3410	0.988015067749287	0.9325509409291044	genomes
global_rank	NA12878	VQSR	False	85	21.0	0.767	0.868	1062	1013	42	7	235095	232087	2845	15700	3368	0.9878901128837281	0.9366391295749978	genomes
global_rank	NA12878	VQSR	False	89	22.0	0.675	0.766	905	871	29	5	236000	232958	2874	14829	3339	0.9878133586620984	0.9401542453801047	genomes
global_rank	NA12878	VQSR	False	93	23.0	0.591	0.674	815	784	23	8	236815	233742	2897	14045	3316	0.987757723790246	0.9433182531771239	genomes
global_rank	NA12878	VQSR	False	97	24.0	0.513	0.591	724	687	29	8	237539	234429	2926	13358	3287	0.9876724737207979	0.9460907957237467	genomes
global_rank	NA12878	VQSR	False	101	25.0	0.439	0.513	677	657	18	2	238216	235086	2944	12701	3269	0.9876318111162459	0.9487422665434425	genomes
global_rank	NA12878	VQSR	False	105	26.0	0.368	0.439	580	557	18	5	238796	235643	2962	12144	3251	0.9875861779929171	0.9509901649400493	genomes
global_rank	NA12878	VQSR	False	109	27.0	0.297	0.367	472	450	20	2	239268	236093	2982	11694	3231	0.9875269266966433	0.9528062408439506	genomes
global_rank	NA12878	VQSR	False	113	28.0	0.227	0.297	458	435	22	1	239726	236528	3004	11259	3209	0.9874588781457175	0.9545617808843886	genomes
global_rank	NA12878	VQSR	False	117	29.0	0.155	0.226	426	404	17	5	240152	236932	3021	10855	3192	0.9874100344650828	0.9561922134736689	genomes
global_rank	NA12878	VQSR	False	121	30.0	0.081	0.154	349	339	10	0	240501	237271	3031	10516	3182	0.987386705062796	0.9575603239879412	genomes
global_rank	NA12878	VQSR	False	125	31.0	0.0055	0.081	343	326	17	0	240844	237597	3048	10190	3165	0.9873340397681232	0.958875970087212	genomes
global_rank	NA12878	VQSR	False	129	32.0	-0.0707	0.0051	324	305	17	2	241168	237902	3065	9885	3148	0.9872804159905714	0.9601068659776341	genomes
global_rank	NA12878	VQSR	False	133	33.0	-0.1465	-0.0708	309	294	12	3	241477	238196	3077	9591	3136	0.9872468117029257	0.9612933689015162	genomes
global_rank	NA12878	VQSR	False	137	34.0	-0.2201	-0.147	249	230	14	5	241726	238426	3091	9361	3122	0.9872017290708315	0.9622215854746213	genomes
global_rank	NA12878	VQSR	False	141	35.0	-0.2902	-0.2209	248	231	14	3	241974	238657	3105	9130	3108	0.9871567905626194	0.9631538377719574	genomes
global_rank	NA12878	VQSR	False	145	36.0	-0.3556	-0.2912	209	197	11	1	242183	238854	3116	8933	3097	0.9871223705418027	0.963948875445443	genomes
global_rank	NA12878	VQSR	False	149	37.0	-0.4169	-0.3557	174	164	9	1	242357	239018	3125	8769	3088	0.9870944028941576	0.9646107342193093	genomes
global_rank	NA12878	VQSR	False	153	38.0	-0.476	-0.418	204	181	23	0	242561	239199	3148	8588	3065	0.9870103611763298	0.9653412003051007	genomes
global_rank	NA12878	VQSR	False	157	39.0	-0.5327	-0.4771	159	153	4	2	242720	239352	3152	8435	3061	0.9870022762511134	0.9659586661124272	genomes
global_rank	NA12878	VQSR	False	161	40.0	-0.5886	-0.5332	161	147	10	4	242881	239499	3162	8288	3051	0.9869694759355644	0.9665519175743683	genomes
global_rank	NA12878	VQSR	False	165	41.0	-0.6438	-0.5889	180	167	11	2	243061	239666	3173	8121	3040	0.9869337297551052	0.9672258835209272	genomes
global_rank	NA12878	VQSR	False	169	42.0	-0.6985	-0.644	161	151	8	2	243222	239817	3181	7970	3032	0.9869093572786607	0.967835277879792	genomes
global_rank	NA12878	VQSR	False	173	43.0	-0.7528	-0.6991	142	129	11	2	243364	239946	3192	7841	3021	0.9868716531352565	0.968355886305577	genomes
global_rank	NA12878	VQSR	False	177	44.0	-0.8071	-0.7532	167	148	15	4	243531	240094	3207	7693	3006	0.9868187964702159	0.9689531734917489	genomes
global_rank	NA12878	VQSR	False	181	45.0	-0.8614	-0.8076	161	148	11	2	243692	240242	3218	7545	2995	0.9867822229524357	0.9695504606779209	genomes
global_rank	NA12878	VQSR	False	185	46.0	-0.9171	-0.8625	144	127	13	4	243836	240369	3231	7418	2982	0.9867364532019705	0.9700629976552442	genomes
global_rank	NA12878	VQSR	False	189	47.0	-0.9723	-0.9175	156	133	19	4	243992	240502	3250	7285	2963	0.9866667760674784	0.9705997489779529	genomes
global_rank	NA12878	VQSR	False	193	48.0	-1.029	-0.9733	132	117	15	0	244124	240619	3265	7168	2948	0.9866124879040855	0.9710719287129672	genomes
global_rank	NA12878	VQSR	False	197	49.0	-1.086	-1.03	131	116	14	1	244255	240735	3279	7052	2934	0.9865622464284836	0.9715400727237506	genomes
global_rank	NA12878	VQSR	False	201	50.0	-1.143	-1.088	153	139	13	1	244408	240874	3292	6913	2921	0.9865173693307012	0.9721010383918446	genomes
global_rank	NA12878	VQSR	False	205	51.0	-1.199	-1.145	127	112	13	2	244535	240986	3305	6801	2908	0.9864710529655206	0.9725530395057045	genomes
global_rank	NA12878	VQSR	False	209	52.0	-1.256	-1.2	113	100	12	1	244648	241086	3317	6701	2896	0.9864281535005708	0.9729566119287937	genomes
global_rank	NA12878	VQSR	False	213	53.0	-1.313	-1.258	119	103	14	2	244767	241189	3331	6598	2882	0.986377392442336	0.9733722915245755	genomes
global_rank	NA12878	VQSR	False	217	54.0	-1.369	-1.314	126	115	7	4	244893	241304	3338	6483	2875	0.9863555726326633	0.9738363998111281	genomes
global_rank	NA12878	VQSR	False	221	55.0	-1.423	-1.369	150	127	19	4	245043	241431	3357	6356	2856	0.9862860924555126	0.9743489367884514	genomes
global_rank	NA12878	VQSR	False	225	56.0	-1.477	-1.425	113	96	14	3	245156	241527	3371	6260	2842	0.9862350856274857	0.974736366314617	genomes
global_rank	NA12878	VQSR	False	229	57.0	-1.53	-1.478	103	85	15	3	245259	241612	3386	6175	2827	0.9861794790161552	0.9750794028742428	genomes
global_rank	NA12878	VQSR	False	233	58.0	-1.582	-1.531	115	90	22	3	245374	241702	3408	6085	2805	0.9860960385133205	0.9754426180550231	genomes
global_rank	NA12878	VQSR	False	237	59.0	-1.631	-1.582	100	87	12	1	245474	241789	3420	5998	2793	0.9860527142152204	0.9757937260631107	genomes
global_rank	NA12878	VQSR	False	241	60.0	-1.679	-1.632	101	84	14	3	245575	241873	3434	5914	2779	0.9860012148043065	0.9761327268985056	genomes
global_rank	NA12878	VQSR	False	245	61.0	-1.727	-1.682	98	85	12	1	245673	241958	3446	5829	2767	0.9859578490978143	0.9764757634581314	genomes
global_rank	NA12878	VQSR	False	249	62.0	-1.771	-1.727	96	80	13	3	245769	242038	3459	5749	2754	0.9859102147887754	0.9767986213966027	genomes
global_rank	NA12878	VQSR	False	253	63.0	-1.814	-1.772	82	68	13	1	245851	242106	3472	5681	2741	0.985861925742534	0.9770730506443034	genomes
global_rank	NA12878	VQSR	False	257	64.0	-1.856	-1.815	76	64	12	0	245927	242170	3484	5617	2729	0.9858174505605445	0.9773313369950805	genomes
global_rank	NA12878	VQSR	False	261	65.0	-1.898	-1.857	82	65	17	0	246009	242235	3501	5552	2712	0.985753003222971	0.9775936590700884	genomes
global_rank	NA12878	VQSR	False	265	66.0	-1.938	-1.898	93	78	13	2	246102	242313	3514	5474	2699	0.9857053944440602	0.977908445560098	genomes
global_rank	NA12878	VQSR	False	269	67.0	-1.977	-1.938	83	71	11	1	246185	242384	3525	5403	2688	0.9856654290814895	0.9781949819804913	genomes
global_rank	NA12878	VQSR	False	273	68.0	-2.016	-1.978	96	82	13	1	246281	242466	3538	5321	2675	0.9856181200305686	0.9785259113674244	genomes
global_rank	NA12878	VQSR	False	277	69.0	-2.055	-2.017	74	52	22	0	246355	242518	3560	5269	2653	0.9855330423686799	0.9787357690274309	genomes
global_rank	NA12878	VQSR	False	281	70.0	-2.093	-2.056	68	60	7	1	246423	242578	3567	5209	2646	0.9855085417132178	0.9789779124812843	genomes
global_rank	NA12878	VQSR	False	285	71.0	-2.133	-2.094	93	67	24	2	246516	242645	3591	5142	2622	0.9854164297665654	0.9792483060047541	genomes
global_rank	NA12878	VQSR	False	289	72.0	-2.172	-2.133	71	53	18	0	246587	242698	3609	5089	2604	0.9853475540687029	0.9794621993889914	genomes
global_rank	NA12878	VQSR	False	293	73.0	-2.214	-2.173	72	62	9	1	246659	242760	3618	5027	2595	0.9853152473029247	0.9797124142913066	genomes
global_rank	NA12878	VQSR	False	297	74.0	-2.256	-2.214	75	54	20	1	246734	242814	3638	4973	2575	0.9852385048609871	0.9799303433997748	genomes
global_rank	NA12878	VQSR	False	301	75.0	-2.301	-2.257	43	33	10	0	246777	242847	3648	4940	2565	0.985200511166555	0.9800635222993942	genomes
global_rank	NA12878	VQSR	False	305	76.0	-2.348	-2.303	78	58	17	3	246855	242905	3665	4882	2548	0.9851360668370037	0.9802975943047859	genomes
global_rank	NA12878	VQSR	False	309	77.0	-2.399	-2.35	75	58	16	1	246930	242963	3681	4824	2532	0.9850756556007849	0.9805316663101777	genomes
global_rank	NA12878	VQSR	False	313	78.0	-2.451	-2.399	75	55	18	2	247005	243018	3699	4769	2514	0.985007113413344	0.9807536311428767	genomes
global_rank	NA12878	VQSR	False	317	79.0	-2.506	-2.453	67	50	17	0	247072	243068	3716	4719	2497	0.9849422977178424	0.9809554173544214	genomes
global_rank	NA12878	VQSR	False	321	80.0	-2.564	-2.508	63	47	15	1	247135	243115	3731	4672	2482	0.9848853131101982	0.9811450963932733	genomes
global_rank	NA12878	VQSR	False	325	81.0	-2.627	-2.568	78	57	19	2	247213	243172	3750	4615	2463	0.9848130178760904	0.9813751326744341	genomes
global_rank	NA12878	VQSR	False	329	82.0	-2.696	-2.631	84	59	25	0	247297	243231	3775	4556	2438	0.984716970437965	0.9816132404040567	genomes
global_rank	NA12878	VQSR	False	333	83.0	-2.771	-2.698	90	56	32	2	247387	243287	3807	4500	2406	0.984592907962152	0.9818392409609866	genomes
global_rank	NA12878	VQSR	False	337	84.0	-2.855	-2.773	85	64	21	0	247472	243351	3828	4436	2385	0.9845132474846164	0.9820975273117637	genomes
global_rank	NA12878	VQSR	False	341	85.0	-2.952	-2.856	97	63	33	1	247569	243414	3861	4373	2352	0.9843858052775251	0.98235177793831	genomes
global_rank	NA12878	VQSR	False	345	86.0	-3.063	-2.952	119	55	62	2	247688	243469	3923	4318	2290	0.9841425753460096	0.982573742771009	genomes
global_rank	NA12878	VQSR	False	349	87.0	-3.197	-3.065	137	74	61	2	247825	243543	3984	4244	2229	0.9839047861445418	0.982872386364095	genomes
global_rank	NA12878	VQSR	False	353	88.0	-3.363	-3.198	142	84	58	0	247967	243627	4042	4160	2171	0.9836798307418368	0.9832113871994899	genomes
global_rank	NA12878	VQSR	False	357	89.0	-3.575	-3.366	171	92	77	2	248138	243719	4119	4068	2094	0.9833802725974226	0.983582673828732	genomes
global_rank	NA12878	VQSR	False	361	90.0	-3.865	-3.577	221	107	113	1	248359	243826	4232	3961	1981	0.9829394738327326	0.9840144963214373	genomes
global_rank	NA12878	VQSR	False	365	91.0	-4.29	-3.867	252	144	107	1	248611	243970	4339	3817	1874	0.9825258045419215	0.9845956406106858	genomes
global_rank	NA12878	VQSR	False	369	92.0	-5.007	-4.298	349	207	138	4	248960	244177	4477	3610	1736	0.9819950614106349	0.9854310355264804	genomes
global_rank	NA12878	VQSR	False	373	93.0	-6.234	-5.015	340	226	112	2	249300	244403	4589	3384	1624	0.9815696889859915	0.986343109202662	genomes
global_rank	NA12878	VQSR	False	377	94.0	-8.215	-6.248	149	59	89	1	249449	244462	4678	3325	1535	0.9812234085253271	0.9865812169322846	genomes
global_rank	NA12878	VQSR	False	381	95.0	-11.13	-8.395	83	2	81	0	249532	244464	4759	3323	1454	0.9809046516573511	0.9865892883807463	genomes
global_rank	NA12878	VQSR	False	385	96.0	-14.68	-11.24	58	2	56	0	249590	244466	4815	3321	1398	0.9806844484738106	0.9865973598292082	genomes
global_rank	NA12878	VQSR	False	389	97.0	-21.26	-15.12	81	3	77	1	249671	244469	4892	3318	1321	0.9803818560239973	0.9866094670019008	genomes
global_rank	NA12878	VQSR	False	393	98.0	-34.84	-21.49	100	6	94	0	249771	244475	4986	3312	1227	0.98001290782928	0.9866336813472861	genomes
global_rank	NA12878	VQSR	False	397	99.0	-950.6	-35.24	1346	118	1227	1	251117	244593	6213	3194	0	0.9752278653620727	0.9871098968065314	genomes
global_rank	NA12878	VQSR	False	401	-1.0	-1.0	-1.0	2883	0	0	2883	254000	244593	6213	3194	0	0.9752278653620727	0.9871098968065314	genomes
global_rank	NA12878	VQSR	True	405	0.0	21.46	162.54	1399179	1398901	223	55	1399179	1398901	223	1715924	29981	0.9998406145559651	0.44911062419237036	genomes
global_rank	NA12878	VQSR	True	409	1.0	20.88	21.46	545627	545527	65	35	1944806	1944428	288	1170397	29916	0.9998519063966153	0.6242495164254813	genomes
global_rank	NA12878	VQSR	True	413	2.0	20.47	20.88	221769	221704	52	13	2166575	2166132	340	948693	29864	0.9998430628228752	0.6954265488430329	genomes
global_rank	NA12878	VQSR	True	417	3.0	19.95	20.47	150192	150106	69	17	2316767	2316238	409	798587	29795	0.9998234517386551	0.743617378183365	genomes
global_rank	NA12878	VQSR	True	421	4.0	19.19	19.95	173913	173830	75	8	2490680	2490068	484	624757	29720	0.9998056655713271	0.7994246867801562	genomes
global_rank	NA12878	VQSR	True	425	5.0	18.49	19.19	121237	121113	100	24	2611917	2611181	584	503644	29620	0.999776396421577	0.8383074490541202	genomes
global_rank	NA12878	VQSR	True	429	6.0	18.15	18.49	48596	48523	60	13	2660513	2659704	644	455121	29560	0.9997579264066205	0.8538855312898799	genomes
global_rank	NA12878	VQSR	True	433	7.0	17.79	18.15	40719	40653	59	7	2701232	2700357	703	414468	29501	0.9997397318089936	0.8669369868291156	genomes
global_rank	NA12878	VQSR	True	437	8.0	17.35	17.79	40368	40312	45	11	2741600	2740669	748	374156	29456	0.9997271484053685	0.8798789659130127	genomes
global_rank	NA12878	VQSR	True	441	9.0	16.95	17.35	36009	35941	59	9	2777609	2776610	807	338215	29397	0.999709442262361	0.8914176558875699	genomes
global_rank	NA12878	VQSR	True	445	10.0	16.61	16.95	24004	23959	36	9	2801613	2800569	843	314256	29361	0.9996990803209239	0.8991095807950688	genomes
global_rank	NA12878	VQSR	True	449	11.0	16.32	16.61	17243	17211	28	4	2818856	2817780	871	297045	29333	0.9996909869295632	0.9046350918590932	genomes
global_rank	NA12878	VQSR	True	453	12.0	16.04	16.32	9994	9958	31	5	2828850	2827738	902	287087	29302	0.9996811188415634	0.9078320611912387	genomes
global_rank	NA12878	VQSR	True	457	13.0	15.8	16.04	6284	6246	33	5	2835134	2833984	935	280841	29269	0.9996701845802296	0.9098373102822791	genomes
global_rank	NA12878	VQSR	True	461	14.0	15.63	15.8	3948	3920	22	6	2839082	2837904	957	276921	29247	0.9996628929701031	0.9110958079506875	genomes
global_rank	NA12878	VQSR	True	465	15.0	15.49	15.63	2973	2944	24	5	2842055	2840848	981	273977	29223	0.9996547997785933	0.9120409653832879	genomes
global_rank	NA12878	VQSR	True	469	16.0	15.37	15.49	2568	2552	14	2	2844623	2843400	995	271425	29209	0.999650189231805	0.9128602730490477	genomes
global_rank	NA12878	VQSR	True	473	17.0	15.26	15.36	2237	2221	16	0	2846860	2845621	1011	269204	29193	0.9996448434500842	0.9135733147127045	genomes
global_rank	NA12878	VQSR	True	477	18.0	15.16	15.26	1958	1934	21	3	2848818	2847555	1032	267270	29172	0.999637715119812	0.9141942163684958	genomes
global_rank	NA12878	VQSR	True	481	19.0	15.06	15.16	1756	1738	15	3	2850574	2849293	1047	265532	29157	0.9996326754001277	0.9147521931408666	genomes
global_rank	NA12878	VQSR	True	485	20.0	14.98	15.06	1857	1841	13	3	2852431	2851134	1060	263691	29144	0.9996283562759055	0.9153432375815655	genomes
global_rank	NA12878	VQSR	True	489	21.0	14.9	14.98	1840	1824	14	2	2854271	2852958	1074	261867	29130	0.9996236902739702	0.9159288242517637	genomes
global_rank	NA12878	VQSR	True	493	22.0	14.82	14.9	1758	1743	14	1	2856029	2854701	1088	260124	29116	0.999619019472377	0.9164884062507525	genomes
global_rank	NA12878	VQSR	True	497	23.0	14.75	14.82	1661	1639	19	3	2857690	2856340	1107	258485	29097	0.9996125912396625	0.9170145995360895	genomes
global_rank	NA12878	VQSR	True	501	24.0	14.68	14.75	1537	1521	14	2	2859227	2857861	1121	256964	29083	0.9996079023932295	0.9175029094732449	genomes
global_rank	NA12878	VQSR	True	505	25.0	14.61	14.68	1408	1398	10	0	2860635	2859259	1131	255566	29073	0.9996045993728128	0.9179517308356007	genomes
global_rank	NA12878	VQSR	True	509	26.0	14.55	14.61	1323	1312	8	3	2861958	2860571	1139	254254	29065	0.9996019862250193	0.9183729423001292	genomes
global_rank	NA12878	VQSR	True	513	27.0	14.49	14.55	1281	1261	17	3	2863239	2861832	1156	252993	29048	0.9995962260407658	0.9187777804531555	genomes
global_rank	NA12878	VQSR	True	517	28.0	14.43	14.49	1107	1099	6	2	2864346	2862931	1162	251894	29042	0.9995942869173592	0.9191306092637628	genomes
global_rank	NA12878	VQSR	True	521	29.0	14.38	14.43	1008	992	16	0	2865354	2863923	1178	250902	29026	0.9995888452099944	0.9194490862247477	genomes
global_rank	NA12878	VQSR	True	525	30.0	14.33	14.38	926	914	10	2	2866280	2864837	1188	249988	29016	0.9995854886122766	0.919742521650494	genomes
global_rank	NA12878	VQSR	True	529	31.0	14.28	14.33	838	815	23	0	2867118	2865652	1211	249173	28993	0.9995775870699088	0.9200041735892065	genomes
global_rank	NA12878	VQSR	True	533	32.0	14.23	14.28	816	800	16	0	2867934	2866452	1227	248373	28977	0.9995721278427606	0.9202610098480652	genomes
global_rank	NA12878	VQSR	True	537	33.0	14.19	14.23	758	735	19	4	2868692	2867187	1246	247638	28958	0.9995656164881662	0.9204969781608918	genomes
global_rank	NA12878	VQSR	True	541	34.0	14.14	14.19	664	650	14	0	2869356	2867837	1260	246988	28944	0.9995608374342171	0.9207056576212147	genomes
global_rank	NA12878	VQSR	True	545	35.0	14.11	14.14	605	593	11	1	2869961	2868430	1271	246395	28933	0.999557096714954	0.9208960374980938	genomes
global_rank	NA12878	VQSR	True	549	36.0	14.07	14.11	540	533	5	2	2870501	2868963	1276	245862	28928	0.9995554377179043	0.9210671546555586	genomes
global_rank	NA12878	VQSR	True	553	37.0	14.04	14.07	491	480	10	1	2870992	2869443	1286	245382	28918	0.9995520301637668	0.9212212564108738	genomes
global_rank	NA12878	VQSR	True	557	38.0	14.01	14.04	488	475	13	0	2871480	2869918	1299	244907	28905	0.9995475786051699	0.9213737529395712	genomes
global_rank	NA12878	VQSR	True	561	39.0	13.97	14.01	431	414	16	1	2871911	2870332	1315	244493	28889	0.999542074635218	0.9215066657035307	genomes
global_rank	NA12878	VQSR	True	565	40.0	13.94	13.97	463	452	11	0	2872374	2870784	1326	244041	28878	0.9995383185184411	0.9216517781897859	genomes
global_rank	NA12878	VQSR	True	569	41.0	13.91	13.94	455	447	8	0	2872829	2871231	1334	243594	28870	0.9995356066790482	0.9217952854494234	genomes
global_rank	NA12878	VQSR	True	573	42.0	13.88	13.91	412	401	10	1	2873241	2871632	1344	243193	28860	0.9995321924025818	0.9219240246241763	genomes
global_rank	NA12878	VQSR	True	577	43.0	13.85	13.88	418	404	12	2	2873659	2872036	1356	242789	28848	0.99952808388135	0.9220537269349001	genomes
global_rank	NA12878	VQSR	True	581	44.0	13.82	13.85	406	398	7	1	2874065	2872434	1363	242391	28841	0.9995257145859642	0.9221815029736823	genomes
global_rank	NA12878	VQSR	True	585	45.0	13.79	13.82	397	388	9	0	2874462	2872822	1372	242003	28832	0.9995226487843201	0.9223060685592288	genomes
global_rank	NA12878	VQSR	True	589	46.0	13.76	13.79	390	378	11	1	2874852	2873200	1383	241625	28821	0.9995188867393984	0.9224274236915396	genomes
global_rank	NA12878	VQSR	True	593	47.0	13.73	13.76	369	357	10	2	2875221	2873557	1393	241268	28811	0.999515469834258	0.9225420368720554	genomes
global_rank	NA12878	VQSR	True	597	48.0	13.7	13.73	372	360	11	1	2875593	2873917	1404	240908	28800	0.9995117066929223	0.9226576131885419	genomes
global_rank	NA12878	VQSR	True	601	49.0	13.67	13.7	363	351	11	1	2875956	2874268	1415	240557	28789	0.9995079429825888	0.9227703000971162	genomes
global_rank	NA12878	VQSR	True	605	50.0	13.64	13.67	364	350	14	0	2876320	2874618	1429	240207	28775	0.9995031374661123	0.9228826659603669	genomes
global_rank	NA12878	VQSR	True	609	51.0	13.61	13.64	365	348	16	1	2876685	2874966	1445	239859	28759	0.9994976378549519	0.9229943897329705	genomes
global_rank	NA12878	VQSR	True	613	52.0	13.58	13.61	348	330	17	1	2877033	2875296	1462	239529	28742	0.9994917890208352	0.9231003346897498	genomes
global_rank	NA12878	VQSR	True	617	53.0	13.55	13.58	378	356	20	2	2877411	2875652	1482	239173	28722	0.9994849040746798	0.923214626824942	genomes
global_rank	NA12878	VQSR	True	621	54.0	13.52	13.55	346	329	16	1	2877757	2875981	1498	238844	28706	0.999479405410083	0.9233202507363977	genomes
global_rank	NA12878	VQSR	True	625	55.0	13.49	13.52	351	339	12	0	2878108	2876320	1510	238505	28694	0.9994752990968889	0.9234290851010891	genomes
global_rank	NA12878	VQSR	True	629	56.0	13.45	13.49	384	369	14	1	2878492	2876689	1524	238136	28680	0.999470504788909	0.9235475508254878	genomes
global_rank	NA12878	VQSR	True	633	57.0	13.42	13.45	366	349	17	0	2878858	2877038	1541	237787	28663	0.9994646664204804	0.9236595956434149	genomes
global_rank	NA12878	VQSR	True	637	58.0	13.39	13.42	368	348	20	0	2879226	2877386	1561	237439	28643	0.9994577878647992	0.9237713194160185	genomes
global_rank	NA12878	VQSR	True	641	59.0	13.35	13.39	382	358	23	1	2879608	2877744	1584	237081	28620	0.9994498716367153	0.9238862536418578	genomes
global_rank	NA12878	VQSR	True	645	60.0	13.32	13.35	414	395	17	2	2880022	2878139	1601	236686	28603	0.9994440470320237	0.9240130665446694	genomes
global_rank	NA12878	VQSR	True	649	61.0	13.28	13.31	395	368	26	1	2880417	2878507	1627	236318	28577	0.9994350957281849	0.9241312112237445	genomes
global_rank	NA12878	VQSR	True	653	62.0	13.24	13.28	423	397	26	0	2880840	2878904	1653	235921	28551	0.9994261526503381	0.9242586662172032	genomes
global_rank	NA12878	VQSR	True	657	63.0	13.2	13.24	392	367	22	3	2881232	2879271	1675	235554	28529	0.9994185937535796	0.9243764898509547	genomes
global_rank	NA12878	VQSR	True	661	64.0	13.15	13.2	442	430	11	1	2881674	2879701	1686	235124	28518	0.9994148651326601	0.9245145393400913	genomes
global_rank	NA12878	VQSR	True	665	65.0	13.11	13.15	453	411	40	2	2882127	2880112	1726	234713	28478	0.9994010766739837	0.9246464889680801	genomes
global_rank	NA12878	VQSR	True	669	66.0	13.06	13.11	468	422	43	3	2882595	2880534	1769	234291	28435	0.9993862546720452	0.9247819700946281	genomes
global_rank	NA12878	VQSR	True	673	67.0	13.0	13.06	485	456	24	5	2883080	2880990	1793	233835	28411	0.9993780315757378	0.9249283667621776	genomes
global_rank	NA12878	VQSR	True	677	68.0	12.95	13.0	500	463	37	0	2883580	2881453	1830	233372	28374	0.9993653068394605	0.9250770107469922	genomes
global_rank	NA12878	VQSR	True	681	69.0	12.89	12.95	554	514	38	2	2884134	2881967	1868	232858	28336	0.9993522514290866	0.925242028043309	genomes
global_rank	NA12878	VQSR	True	685	70.0	12.82	12.89	546	497	48	1	2884680	2882464	1916	232361	28288	0.9993357324624356	0.925401587569125	genomes
global_rank	NA12878	VQSR	True	689	71.0	12.75	12.82	620	568	51	1	2885300	2883032	1967	231793	28237	0.9993181973373301	0.9255839413129149	genomes
global_rank	NA12878	VQSR	True	693	72.0	12.68	12.75	597	542	52	3	2885897	2883574	2019	231251	28185	0.9993003171271901	0.9257579478782917	genomes
global_rank	NA12878	VQSR	True	697	73.0	12.59	12.68	612	561	51	0	2886509	2884135	2070	230690	28134	0.9992827952276432	0.9259380543048165	genomes
global_rank	NA12878	VQSR	True	701	74.0	12.49	12.59	672	604	66	2	2887181	2884739	2136	230086	28068	0.9992600995886556	0.9261319656802549	genomes
global_rank	NA12878	VQSR	True	705	75.0	12.38	12.49	651	588	52	11	2887832	2885327	2188	229498	28016	0.9992422550185887	0.9263207403305161	genomes
global_rank	NA12878	VQSR	True	709	76.0	12.26	12.38	670	606	59	5	2888502	2885933	2247	228892	27957	0.9992220013988048	0.9265152937966017	genomes
global_rank	NA12878	VQSR	True	713	77.0	12.11	12.26	641	580	56	5	2889143	2886513	2303	228312	27901	0.999202787578025	0.9267015000842744	genomes
global_rank	NA12878	VQSR	True	717	78.0	11.93	12.11	625	551	68	6	2889768	2887064	2371	227761	27833	0.9991794243511275	0.9268783960575634	genomes
global_rank	NA12878	VQSR	True	721	79.0	11.7	11.93	525	447	75	3	2890293	2887511	2446	227314	27758	0.9991536206248052	0.9270219033172008	genomes
global_rank	NA12878	VQSR	True	725	80.0	11.35	11.7	445	356	86	3	2890738	2887867	2532	226958	27672	0.9991239963755869	0.927136195452393	genomes
global_rank	NA12878	VQSR	True	729	81.0	10.58	11.35	413	266	140	7	2891151	2888133	2672	226692	27532	0.9990756899894666	0.9272215935084636	genomes
global_rank	NA12878	VQSR	True	733	82.0	3.51	10.57	17280	16741	417	122	2908431	2904874	3089	209951	27115	0.9989377443935841	0.9325962132704084	genomes
global_rank	NA12878	VQSR	True	737	83.0	-0.0262	3.51	98889	98341	344	204	3007320	3003215	3433	111610	26771	0.9988581969023311	0.9641681314359555	genomes
global_rank	NA12878	VQSR	True	741	84.0	-0.8501	-0.0262	29404	29237	109	58	3036724	3032452	3542	82373	26662	0.9988333310276635	0.9735545335612755	genomes
global_rank	NA12878	VQSR	True	745	85.0	-1.365	-0.8501	5750	5619	91	40	3042474	3038071	3633	76754	26571	0.9988056037010833	0.9753584872344353	genomes
global_rank	NA12878	VQSR	True	749	86.0	-1.734	-1.365	3486	3386	70	30	3045960	3041457	3703	73368	26501	0.998783971942361	0.9764455467000553	genomes
global_rank	NA12878	VQSR	True	753	87.0	-2.038	-1.734	2578	2475	91	12	3048538	3043932	3794	70893	26410	0.9987551374368956	0.9772401338758999	genomes
global_rank	NA12878	VQSR	True	757	88.0	-2.384	-2.039	2595	2494	86	15	3051133	3046426	3880	68399	26324	0.9987279964698623	0.9780408209128924	genomes
global_rank	NA12878	VQSR	True	761	89.0	-2.83	-2.384	2950	2805	137	8	3054083	3049231	4017	65594	26187	0.998684351877083	0.9789413530455162	genomes
global_rank	NA12878	VQSR	True	765	90.0	-3.447	-2.83	3576	3373	190	13	3057659	3052604	4207	62221	25997	0.9986237291085382	0.9800242389219298	genomes
global_rank	NA12878	VQSR	True	769	91.0	-4.31	-3.447	4544	4179	345	20	3062203	3056783	4552	58042	25652	0.9985130670116142	0.9813658873291436	genomes
global_rank	NA12878	VQSR	True	773	92.0	-5.544	-4.311	5669	4904	740	25	3067872	3061687	5292	53138	24912	0.9982745235621111	0.9829402935959484	genomes
global_rank	NA12878	VQSR	True	777	93.0	-7.355	-5.544	7753	6220	1515	18	3075625	3067907	6807	46918	23397	0.9977861355560225	0.984937195508576	genomes
global_rank	NA12878	VQSR	True	781	94.0	-10.34	-7.355	10895	8875	1989	31	3086520	3076782	8796	38043	21408	0.9971493185393466	0.9877864727552912	genomes
global_rank	NA12878	VQSR	True	785	95.0	-15.31	-10.34	14560	12741	1772	47	3101080	3089523	10568	25302	19636	0.99659106781059	0.9918769112229419	genomes
global_rank	NA12878	VQSR	True	789	96.0	-22.96	-15.31	15931	13881	1919	131	3117011	3103404	12487	11421	17717	0.995992478555893	0.9963333413594664	genomes
global_rank	NA12878	VQSR	True	793	97.0	-36.55	-22.97	7126	4604	2315	207	3124137	3108008	14802	6817	15402	0.9952600382347949	0.997811434029199	genomes
global_rank	NA12878	VQSR	True	797	98.0	-73.63	-36.56	3469	1183	2152	134	3127606	3109191	16954	5634	13250	0.9945767070945206	0.9981912306469866	genomes
global_rank	NA12878	VQSR	True	801	99.0	-16980.0	-73.66	15540	2137	13248	155	3143146	3111328	30202	3497	2	0.9903862130872536	0.9988773045034632	genomes
global_rank	NA12878	VQSR	True	804	100.0	-1.0	-1.0	2	0	2	0	3143148	3111328	30204	3497	0	0.990385582575635	0.9988773045034632	genomes
global_rank	NA12878	VQSR	True	807	-1.0	-1.0	-1.0	1881	0	0	1881	3145029	3111328	30204	3497	0	0.990385582575635	0.9988773045034632	genomes
global_rank	syndip	RF	False	2	0.0	0.9615335854860718	0.9617872044416576	8165	7963	198	4	8165	7963	198	145053	18614	0.975738267369195	0.05204030951011659	genomes
global_rank	syndip	RF	False	6	1.0	0.9606646027222919	0.9614095443591661	31896	30722	1153	21	40061	38685	1351	114331	17461	0.9662553701668498	0.2528166989073038	genomes
global_rank	syndip	RF	False	10	2.0	0.9575525460719533	0.9606646027222919	9411	9043	354	14	49472	47728	1705	105288	17107	0.9655088705925192	0.31191509384639515	genomes
global_rank	syndip	RF	False	14	3.0	0.9566835633081735	0.9575525460719533	3128	3010	117	1	52600	50738	1822	102278	16990	0.9653348554033485	0.33158623934751924	genomes
global_rank	syndip	RF	False	18	4.0	0.9517161674658469	0.9566835633081735	1611	1463	135	13	54211	52201	1957	100815	16855	0.9638649876287898	0.34114733099806555	genomes
global_rank	syndip	RF	False	22	5.0	0.948919993860841	0.9517026107809463	592	533	49	10	54803	52734	2006	100282	16806	0.9633540372670808	0.3446306268625503	genomes
global_rank	syndip	RF	False	26	6.0	0.9473574679692369	0.9488925188579131	147	137	10	0	54950	52871	2016	100145	16796	0.9632699910725673	0.34552595806974434	genomes
global_rank	syndip	RF	False	30	7.0	0.9431692607520791	0.9473489765505096	11503	11097	398	8	66453	63968	2414	89048	16398	0.9636347202554909	0.4180477858524599	genomes
global_rank	syndip	RF	False	34	8.0	0.938848611334415	0.9429835132592007	1118	1040	75	3	67571	65008	2489	88008	16323	0.9631242870053484	0.4248444607099911	genomes
global_rank	syndip	RF	False	38	9.0	0.9328163293188892	0.938848611334415	517	456	51	10	68088	65464	2540	87552	16272	0.9626492559261219	0.42782454122444713	genomes
global_rank	syndip	RF	False	42	10.0	0.9319359377705994	0.9328163293188892	4322	4017	232	73	72410	69481	2772	83535	16040	0.9616348110113075	0.45407669786166155	genomes
global_rank	syndip	RF	False	46	11.0	0.9302727524052729	0.9319359377705994	4451	4102	265	84	76861	73583	3037	79433	15775	0.9603628295484208	0.4808843519631934	genomes
global_rank	syndip	RF	False	50	12.0	0.9289403700760861	0.9302727524052729	5167	4833	255	79	82028	78416	3292	74600	15520	0.9597101874969404	0.5124692842578554	genomes
global_rank	syndip	RF	False	54	13.0	0.9274464531886615	0.9289403700760861	4548	4153	341	54	86576	82569	3633	70447	15179	0.9578548061529895	0.5396102368379777	genomes
global_rank	syndip	RF	False	58	14.0	0.9256780418713382	0.9274457556994199	3410	3112	251	47	89986	85681	3884	67335	14928	0.956634846201083	0.5599479792962827	genomes
global_rank	syndip	RF	False	62	15.0	0.9235162881417103	0.9256716634541369	1711	1510	148	53	91697	87191	4032	65825	14780	0.9558006204575601	0.5698162283682752	genomes
global_rank	syndip	RF	False	66	16.0	0.9209632647915988	0.923513313155762	1172	966	154	52	92869	88157	4186	64859	14626	0.9546690057719589	0.576129293668636	genomes
global_rank	syndip	RF	False	70	17.0	0.9184482859124383	0.9209619710045408	4891	4558	236	97	97760	92715	4422	60301	14390	0.9544766669755088	0.6059170282846238	genomes
global_rank	syndip	RF	False	74	18.0	0.9153514660750874	0.9184440853567767	3451	3161	228	62	101211	95876	4650	57140	14162	0.953743310188409	0.6265749986929472	genomes
global_rank	syndip	RF	False	78	19.0	0.910203331469793	0.9153514660750874	2304	2039	200	65	103515	97915	4850	55101	13962	0.9528049433172773	0.63990040257228	genomes
global_rank	syndip	RF	False	82	20.0	0.9039008985125617	0.9101974860373637	4623	4181	358	84	108138	102096	5208	50920	13604	0.9514649966450458	0.6672243425524128	genomes
global_rank	syndip	RF	False	86	21.0	0.8932511180875621	0.9038884085306195	2013	1769	191	53	110151	103865	5399	49151	13413	0.9505875677258749	0.678785225074502	genomes
global_rank	syndip	RF	False	90	22.0	0.8868314668671974	0.8932005950529684	584	507	65	12	110735	104372	5464	48644	13348	0.9502531046287191	0.6820986040675485	genomes
global_rank	syndip	RF	False	94	23.0	0.8820925111558817	0.8868314668671974	823	667	125	31	111558	105039	5589	47977	13223	0.9494793361535958	0.686457625346369	genomes
global_rank	syndip	RF	False	98	24.0	0.8735630799680825	0.881992425101035	1809	1603	184	22	113367	106642	5773	46374	13039	0.9486456433749945	0.6969336539969676	genomes
global_rank	syndip	RF	False	102	25.0	0.867292914686024	0.8734739691822998	889	730	123	36	114256	107372	5896	45644	12916	0.9479464632552883	0.7017043969258117	genomes
global_rank	syndip	RF	False	106	26.0	0.8611553185239237	0.8672194341372292	764	649	88	27	115020	108021	5984	44995	12828	0.9475110740756985	0.7059457834474826	genomes
global_rank	syndip	RF	False	110	27.0	0.8533187228528335	0.8611183290479412	537	427	70	40	115557	108448	6054	44568	12758	0.947127561090636	0.7087363412976421	genomes
global_rank	syndip	RF	False	114	28.0	0.8468772971989748	0.8532264490795555	218	143	47	28	115775	108591	6101	44425	12711	0.9468053569560213	0.7096708840905526	genomes
global_rank	syndip	RF	False	118	29.0	0.8416820725532934	0.8467172175957346	3701	3184	470	47	119476	111775	6571	41241	12241	0.944476365910128	0.730479165577456	genomes
global_rank	syndip	RF	False	122	30.0	0.8359977366045146	0.8416368973477324	784	604	131	49	120260	112379	6702	40637	12110	0.9437189811976722	0.734426465206253	genomes
global_rank	syndip	RF	False	126	31.0	0.8321991882849413	0.8359977366045146	1345	1034	226	85	121605	113413	6928	39603	11884	0.9424302606759126	0.7411839284780677	genomes
global_rank	syndip	RF	False	130	32.0	0.8283538460366322	0.8321983764515781	796	558	182	56	122401	113971	7110	39045	11702	0.9412789785350303	0.7448306059497046	genomes
global_rank	syndip	RF	False	134	33.0	0.8238993302493696	0.8283340377721576	401	285	91	25	122802	114256	7201	38760	11611	0.9407115275364945	0.7466931562712396	genomes
global_rank	syndip	RF	False	138	34.0	0.8191040848604937	0.8238840117914064	727	556	136	35	123529	114812	7337	38204	11475	0.9399340150144496	0.7503267632143044	genomes
global_rank	syndip	RF	False	142	35.0	0.8134076455908038	0.8190833441090952	503	363	97	43	124032	115175	7434	37841	11378	0.9393682356107627	0.7526990641501542	genomes
global_rank	syndip	RF	False	146	36.0	0.8079608012229773	0.813381996388551	868	611	189	68	124900	115786	7623	37230	11189	0.9382297887512256	0.7566921106289538	genomes
global_rank	syndip	RF	False	150	37.0	0.8031777849873872	0.8079409630663444	744	518	161	65	125644	116304	7784	36712	11028	0.9372703242859906	0.7600773775291473	genomes
global_rank	syndip	RF	False	154	38.0	0.7976308746773312	0.8031573868637053	489	320	108	61	126133	116624	7892	36392	10920	0.9366185871695204	0.7621686621006953	genomes
global_rank	syndip	RF	False	158	39.0	0.7917743413829718	0.7976256970401258	380	200	99	81	126513	116824	7991	36192	10821	0.9359772463245604	0.7634757149579129	genomes
global_rank	syndip	RF	False	162	40.0	0.7864582907775293	0.7916754266942043	364	222	82	60	126877	117046	8073	35970	10739	0.9354774254909326	0.7649265436294244	genomes
global_rank	syndip	RF	False	166	41.0	0.7812230591949879	0.7864009843651375	480	334	104	42	127357	117380	8177	35636	10635	0.9348742005622944	0.7671093219009777	genomes
global_rank	syndip	RF	False	170	42.0	0.7775300372625947	0.7812073590955235	520	407	73	40	127877	117787	8250	35229	10562	0.934543031014702	0.7697691744654154	genomes
global_rank	syndip	RF	False	174	43.0	0.7723445216645392	0.7774717759992826	501	384	78	39	128378	118171	8328	34845	10484	0.9341654874742092	0.7722787159512731	genomes
global_rank	syndip	RF	False	178	44.0	0.7662954585191935	0.7722942680936039	614	413	146	55	128992	118584	8474	34432	10338	0.9333060492058745	0.7749777801014273	genomes
global_rank	syndip	RF	False	182	45.0	0.7620813718299171	0.7662793150783234	1772	1168	530	74	130764	119752	9004	33264	9808	0.9300692783248936	0.7826109687875777	genomes
global_rank	syndip	RF	False	186	46.0	0.7579044217577965	0.7620728634875493	514	329	145	40	131278	120081	9149	32935	9663	0.9292037452603884	0.7847610707377006	genomes
global_rank	syndip	RF	False	190	47.0	0.7506578821111946	0.7578901436223126	874	647	134	93	132152	120728	9283	32288	9529	0.9285983493704378	0.7889893867307994	genomes
global_rank	syndip	RF	False	194	48.0	0.744407512344043	0.7506443111493492	1186	926	163	97	133338	121654	9446	31362	9366	0.9279481311975591	0.7950410414597167	genomes
global_rank	syndip	RF	False	198	49.0	0.7365261469340931	0.7443933914287487	1697	1357	244	96	135035	123011	9690	30005	9122	0.9269786964679995	0.8039093950959377	genomes
global_rank	syndip	RF	False	202	50.0	0.7291029388106622	0.736514527161525	1054	728	252	74	136089	123739	9942	29277	8870	0.9256289225843612	0.8086670674962095	genomes
global_rank	syndip	RF	False	206	51.0	0.718968689292791	0.7290666340482049	801	525	203	73	136890	124264	10145	28752	8667	0.9245214234165867	0.8120980812464056	genomes
global_rank	syndip	RF	False	210	52.0	0.7114990831520944	0.7189197090555363	650	388	206	56	137540	124652	10351	28364	8461	0.9233276297563758	0.8146337637894077	genomes
global_rank	syndip	RF	False	214	53.0	0.7031608264933794	0.7114368201833676	689	455	167	67	138229	125107	10518	27909	8294	0.9224479262672811	0.8176073090395776	genomes
global_rank	syndip	RF	False	218	54.0	0.6948004471779566	0.7031224164042059	629	423	150	56	138858	125530	10668	27486	8144	0.9216728586322853	0.8203717258325927	genomes
global_rank	syndip	RF	False	222	55.0	0.6836311632544071	0.6947729838735882	513	349	102	62	139371	125879	10770	27137	8042	0.9211849336621564	0.8226525330684373	genomes
global_rank	syndip	RF	False	226	56.0	0.6721599338769199	0.6835494367346745	371	209	114	48	139742	126088	10884	26928	7928	0.9205385042198405	0.8240184033042296	genomes
global_rank	syndip	RF	False	230	57.0	0.6613979340819421	0.6721437565307243	308	170	78	60	140050	126258	10962	26758	7850	0.9201136860515959	0.8251293982328646	genomes
global_rank	syndip	RF	False	234	58.0	0.6502865462560105	0.6613979340819421	380	200	105	75	140430	126458	11067	26558	7745	0.9195273586620615	0.8264364510900821	genomes
global_rank	syndip	RF	False	238	59.0	0.6378215366742525	0.6502221764778362	357	202	96	59	140787	126660	11163	26356	7649	0.9190048105178381	0.8277565744758718	genomes
global_rank	syndip	RF	False	242	60.0	0.6275446672111908	0.6377694952003375	385	229	87	69	141172	126889	11250	26127	7562	0.9185602907216645	0.8292531499973859	genomes
global_rank	syndip	RF	False	246	61.0	0.6168627892650078	0.6274857025029488	919	552	274	93	142091	127441	11524	25575	7288	0.9170726441909833	0.8328606158833063	genomes
global_rank	syndip	RF	False	250	62.0	0.6071501979995094	0.616855671861598	1453	1082	297	74	143544	128523	11821	24493	6991	0.9157712477911417	0.8399317718408532	genomes
global_rank	syndip	RF	False	254	63.0	0.5972600205329095	0.6070773229022713	1744	1205	390	149	145288	129728	12211	23288	6601	0.9139700857410578	0.847806765305589	genomes
global_rank	syndip	RF	False	258	64.0	0.5858891952664123	0.5972351121562515	522	271	157	94	145810	129999	12368	23017	6444	0.9131259350832707	0.8495778219271187	genomes
global_rank	syndip	RF	False	262	65.0	0.5702737183966949	0.5858477895693616	543	293	145	105	146353	130292	12513	22724	6299	0.9123770176114282	0.8514926543629424	genomes
global_rank	syndip	RF	False	266	66.0	0.5524955103595858	0.5701832653952629	440	226	134	80	146793	130518	12647	22498	6165	0.9116613697481927	0.8529696240915983	genomes
global_rank	syndip	RF	False	270	67.0	0.5331493175980249	0.5524495140812267	543	302	153	88	147336	130820	12800	22196	6012	0.9108759225734577	0.8549432739059968	genomes
global_rank	syndip	RF	False	274	68.0	0.5154167443870744	0.5329563769317752	206	64	84	58	147542	130884	12884	22132	5928	0.9103833954704802	0.8553615308203064	genomes
global_rank	syndip	RF	False	278	69.0	0.49918186602865566	0.515209779884525	414	222	128	64	147956	131106	13012	21910	5800	0.9097128741725531	0.8568123594918179	genomes
global_rank	syndip	RF	False	282	70.0	0.48082168610651627	0.49914621158430894	262	101	105	56	148218	131207	13117	21809	5695	0.9091142152379369	0.8574724211847127	genomes
global_rank	syndip	RF	False	286	71.0	0.46036504313966786	0.4806021602874571	198	72	74	52	148416	131279	13191	21737	5621	0.9086938464733163	0.8579429602133111	genomes
global_rank	syndip	RF	False	290	72.0	0.43598213149119663	0.460077831727338	217	55	79	83	148633	131334	13270	21682	5542	0.9082321374235844	0.8583023997490459	genomes
global_rank	syndip	RF	False	294	73.0	0.406784615116933	0.43585071761843086	278	91	96	91	148911	131425	13366	21591	5446	0.9076876325185957	0.8588971087990799	genomes
global_rank	syndip	RF	False	298	74.0	0.3765714120477373	0.40655665482894915	252	104	82	66	149163	131529	13448	21487	5364	0.9072404588314008	0.859576776284833	genomes
global_rank	syndip	RF	False	302	75.0	0.3465803246168573	0.37611982215050915	196	36	76	84	149359	131565	13524	21451	5288	0.9067882472137792	0.8598120457991321	genomes
global_rank	syndip	RF	False	306	76.0	0.3110774842682008	0.34596549360985346	268	77	90	101	149627	131642	13614	21374	5198	0.9062758164895082	0.8603152611491609	genomes
global_rank	syndip	RF	False	310	77.0	0.2713207090775574	0.3108560586566916	296	80	103	113	149923	131722	13717	21294	5095	0.9056855451426371	0.860838082292048	genomes
global_rank	syndip	RF	False	314	78.0	0.2416722470744512	0.270987957909284	180	34	56	90	150103	131756	13773	21260	5039	0.9053590693263885	0.8610602812777749	genomes
global_rank	syndip	RF	False	318	79.0	0.22260277824571645	0.24164143766160362	115	32	32	51	150218	131788	13805	21228	5007	0.9051808809489468	0.8612694097349297	genomes
global_rank	syndip	RF	False	322	80.0	0.20625908808995552	0.22205158025080118	136	31	35	70	150354	131819	13840	21197	4972	0.9049835574870073	0.8614720029277984	genomes
global_rank	syndip	RF	False	326	81.0	0.19335684419412044	0.20611978841562018	122	22	43	57	150476	131841	13883	21175	4929	0.9047308610798496	0.8616157787420923	genomes
global_rank	syndip	RF	False	330	82.0	0.17636952964463798	0.1931186509053528	186	49	54	83	150662	131890	13937	21126	4875	0.9044278494380328	0.8619360066921107	genomes
global_rank	syndip	RF	False	334	83.0	0.16016957010173177	0.1760224089506113	248	72	101	75	150910	131962	14038	21054	4774	0.9038493150684932	0.862406545720709	genomes
global_rank	syndip	RF	False	338	84.0	0.14512156081924724	0.15979374427774007	273	114	74	85	151183	132076	14112	20940	4700	0.9034667688182341	0.863151565849323	genomes
global_rank	syndip	RF	False	342	85.0	0.12958751107295202	0.1450823962180662	256	84	89	83	151439	132160	14201	20856	4611	0.90297278646634	0.8637005280493543	genomes
global_rank	syndip	RF	False	346	86.0	0.113873436132272	0.1295139755787982	308	71	135	102	151747	132231	14336	20785	4476	0.9021880778074192	0.8641645318136666	genomes
global_rank	syndip	RF	False	350	87.0	0.09589155008853949	0.1136929645229229	267	55	115	97	152014	132286	14451	20730	4361	0.9015176812937432	0.8645239713494014	genomes
global_rank	syndip	RF	False	354	88.0	0.07898060152623769	0.09574207347400639	259	49	123	87	152273	132335	14574	20681	4238	0.9007957306904274	0.8648441992994197	genomes
global_rank	syndip	RF	False	358	89.0	0.062229215157752336	0.07878638056137055	273	39	161	73	152546	132374	14735	20642	4077	0.899836175896784	0.8650990746065771	genomes
global_rank	syndip	RF	False	362	90.0	0.04689690741881565	0.062065843524202455	324	39	224	61	152870	132413	14959	20603	3853	0.8984949651222756	0.8653539499137345	genomes
global_rank	syndip	RF	False	366	91.0	0.0360652889910244	0.04678112182113542	263	9	210	44	153133	132422	15169	20594	3643	0.8972227303832889	0.8654127672923093	genomes
global_rank	syndip	RF	False	370	92.0	0.026950707715180464	0.036009303132507456	256	8	228	20	153389	132430	15397	20586	3415	0.8958444668429989	0.865465049406598	genomes
global_rank	syndip	RF	False	374	93.0	0.02052402711906335	0.026938095327717418	374	2	358	14	153763	132432	15755	20584	3057	0.8936816319920101	0.8654781199351702	genomes
global_rank	syndip	RF	False	378	94.0	0.014578093043586359	0.020497281824888445	339	3	325	11	154102	132435	16080	20581	2732	0.8917281082718918	0.8654977257280284	genomes
global_rank	syndip	RF	False	382	95.0	0.010626687475067724	0.01457037027995583	436	0	428	8	154538	132435	16508	20581	2304	0.8891656539750106	0.8654977257280284	genomes
global_rank	syndip	RF	False	386	96.0	0.007770230794780849	0.010602077375843656	548	0	542	6	155086	132435	17050	20581	1762	0.8859417332842761	0.8654977257280284	genomes
global_rank	syndip	RF	False	390	97.0	0.005988043454923752	0.007762224592967738	648	0	648	0	155734	132435	17698	20581	1114	0.8821178555014554	0.8654977257280284	genomes
global_rank	syndip	RF	False	394	98.0	0.004317029044231475	0.005983449407016997	410	0	408	2	156144	132435	18106	20581	706	0.8797271175294438	0.8654977257280284	genomes
global_rank	syndip	RF	False	398	99.0	0.0014916482210623925	0.0043105881083640475	574	0	570	4	156718	132435	18676	20581	136	0.8764087326534798	0.8654977257280284	genomes
global_rank	syndip	RF	False	402	-1.0	-1.0	-1.0	15110	290	136	14684	171828	132725	18812	20291	0	0.8758587011752905	0.8673929523709939	genomes
global_rank	syndip	RF	True	406	0.0	0.9719609898644941	0.9719609898644941	333087	332996	74	17	333087	332996	74	2968719	59819	0.9997778244813402	0.1008554645085963	genomes
global_rank	syndip	RF	True	410	1.0	0.9719609898644941	0.9719609898644941	328177	328072	81	24	661264	661068	155	2640647	59738	0.9997655858915978	0.20021958285315358	genomes
global_rank	syndip	RF	True	414	2.0	0.9719609898644941	0.9719609898644941	325378	325295	59	24	986642	986363	214	2315352	59679	0.9997830883955332	0.2987426231519074	genomes
global_rank	syndip	RF	True	418	3.0	0.9719609898644941	0.9719609898644941	324387	324290	66	31	1311029	1310653	280	1991062	59613	0.9997864116625335	0.39696127618525523	genomes
global_rank	syndip	RF	True	422	4.0	0.9719609898644941	0.9719609898644941	326387	326300	64	23	1637416	1636953	344	1664762	59549	0.9997898976178421	0.4957887037494151	genomes
global_rank	syndip	RF	True	426	5.0	0.9715833297820027	0.9719609898644941	706548	706145	293	110	2343964	2343098	637	958617	59256	0.9997282115938876	0.7096608883565056	genomes
global_rank	syndip	RF	True	430	6.0	0.9707170463107051	0.9715833297820027	284813	284681	95	37	2628777	2627779	732	673936	59161	0.9997215153370101	0.7958830486580459	genomes
global_rank	syndip	RF	True	434	7.0	0.9707170463107051	0.9707170463107051	37028	37015	10	3	2665805	2664794	742	636921	59151	0.9997216319719561	0.807093889084915	genomes
global_rank	syndip	RF	True	438	8.0	0.9707170463107051	0.9707170463107051	35760	35747	9	4	2701565	2700541	751	601174	59142	0.9997219848872317	0.817920686673441	genomes
global_rank	syndip	RF	True	442	9.0	0.9707170463107051	0.9707170463107051	35031	35007	21	3	2736596	2735548	772	566167	59121	0.9997178692550579	0.8285233583152998	genomes
global_rank	syndip	RF	True	446	10.0	0.9704465277076896	0.9707170463107051	57841	57762	55	24	2794437	2793310	827	508405	59066	0.999704023102661	0.8460179028171723	genomes
global_rank	syndip	RF	True	450	11.0	0.9693997886081807	0.9704465277076896	71342	71276	52	14	2865779	2864586	879	437129	59014	0.9996932435049809	0.8676054717018277	genomes
global_rank	syndip	RF	True	454	12.0	0.9669020740964359	0.9693997886081807	20034	19995	19	20	2885813	2884581	898	417134	58995	0.9996887865065037	0.8736614153553532	genomes
global_rank	syndip	RF	True	458	13.0	0.9666484551408503	0.9669020740964359	5392	5370	9	13	2891205	2889951	907	411764	58986	0.9996862523167862	0.8752878428331943	genomes
global_rank	syndip	RF	True	462	14.0	0.965593294231448	0.9666484551408503	27800	27716	29	55	2919005	2917667	936	384048	58957	0.9996792986233483	0.8836822681545803	genomes
global_rank	syndip	RF	True	466	15.0	0.965406773606043	0.965593294231448	6092	6062	15	15	2925097	2923729	951	377986	58942	0.9996748362213986	0.8855182836798452	genomes
global_rank	syndip	RF	True	470	16.0	0.9651139194692663	0.965406773606043	14449	14388	27	34	2939546	2938117	978	363598	58915	0.999667244508939	0.8898760189780159	genomes
global_rank	syndip	RF	True	474	17.0	0.9646135610282996	0.9651139194692663	8856	8813	18	25	2948402	2946930	996	354785	58897	0.9996621353453241	0.8925452378536609	genomes
global_rank	syndip	RF	True	478	18.0	0.9638166155900145	0.9646135610282996	5251	5211	19	21	2953653	2952141	1015	349574	58878	0.999656299904238	0.8941235085402586	genomes
global_rank	syndip	RF	True	482	19.0	0.9615918013917737	0.9638166155900145	5086	5059	11	16	2958739	2957200	1026	344515	58867	0.9996531705150317	0.8956557425459193	genomes
global_rank	syndip	RF	True	486	20.0	0.9610522077696162	0.9615918013917737	2250	2243	4	3	2960989	2959443	1030	342272	58863	0.9996520826232835	0.8963350864626414	genomes
global_rank	syndip	RF	True	490	21.0	0.9606639597714645	0.9610522077696162	784	774	6	4	2961773	2960217	1036	341498	58857	0.9996501480960931	0.8965695100879392	genomes
global_rank	syndip	RF	True	494	22.0	0.9594803184192858	0.9606639597714645	2707	2676	8	23	2964480	2962893	1044	338822	58849	0.9996477657925927	0.8973799979707515	genomes
global_rank	syndip	RF	True	498	23.0	0.9547875170713338	0.9594803184192858	3679	3623	10	46	2968159	2966516	1054	335199	58839	0.9996448272492309	0.8984773064907177	genomes
global_rank	syndip	RF	True	502	24.0	0.9518234266298246	0.9547875170713338	9349	9190	113	46	2977508	2975706	1167	326009	58726	0.9996079779016438	0.9012607084500025	genomes
global_rank	syndip	RF	True	506	25.0	0.9496183199326015	0.9518234266298246	2759	2734	18	7	2980267	2978440	1185	323275	58708	0.9996022989470151	0.9020887629610672	genomes
global_rank	syndip	RF	True	510	26.0	0.9475237960751838	0.9495952859623199	5179	5153	12	14	2985446	2983593	1197	318122	58696	0.9995989667614807	0.9036494670194126	genomes
global_rank	syndip	RF	True	514	27.0	0.9462003698700113	0.9475204742178183	3334	3315	13	6	2988780	2986908	1210	314807	58683	0.9995950628455771	0.9046534906859011	genomes
global_rank	syndip	RF	True	518	28.0	0.9433952251108542	0.9461860871458218	1772	1749	17	6	2990552	2988657	1227	313058	58666	0.9995896161857785	0.9051832153895778	genomes
global_rank	syndip	RF	True	522	29.0	0.9362258679510396	0.9433869226681373	9962	9871	41	50	3000514	2998528	1268	303187	58625	0.9995773045900455	0.9081728737943766	genomes
global_rank	syndip	RF	True	526	30.0	0.9332866370442631	0.9362258679510396	23892	23593	115	184	3024406	3022121	1383	279594	58510	0.9995425837042055	0.9153185541453457	genomes
global_rank	syndip	RF	True	530	31.0	0.9310177072368541	0.9332836315477364	6230	6159	40	31	3030636	3028280	1423	273435	58470	0.9995303169980688	0.917183948341998	genomes
global_rank	syndip	RF	True	534	32.0	0.928815924723424	0.9310001728189042	1608	1572	13	23	3032244	3029852	1436	271863	58457	0.9995262739799056	0.9176600645422152	genomes
global_rank	syndip	RF	True	538	33.0	0.927122417238108	0.9288068091369093	1025	976	20	29	3033269	3030828	1456	270887	58437	0.9995198338941866	0.9179556684934951	genomes
global_rank	syndip	RF	True	542	34.0	0.9247975064503365	0.9271001955395417	1295	1212	30	53	3034564	3032040	1486	269675	58407	0.9995101410042307	0.9183227504493877	genomes
global_rank	syndip	RF	True	546	35.0	0.9184679313358064	0.9247761396178177	2062	1938	39	85	3036626	3033978	1525	267737	58368	0.9994976120926252	0.9189097181313348	genomes
global_rank	syndip	RF	True	550	36.0	0.9126499646479015	0.9184614740407839	13071	12974	42	55	3049697	3046952	1567	254763	58326	0.9994859799135252	0.9228391911476308	genomes
global_rank	syndip	RF	True	554	37.0	0.9087621260675526	0.9126499646479015	5046	5013	20	13	3054743	3051965	1587	249750	58306	0.9994802773949814	0.92435749299985	genomes
global_rank	syndip	RF	True	558	38.0	0.9029064858027617	0.9087598875972097	1250	1174	27	49	3055993	3053139	1614	248576	58279	0.9994716430428254	0.9247130657855085	genomes
global_rank	syndip	RF	True	562	39.0	0.8967484283046772	0.9028914082249991	1153	1068	63	22	3057146	3054207	1677	247508	58216	0.9994512226249426	0.9250365340436713	genomes
global_rank	syndip	RF	True	566	40.0	0.8916751180060004	0.8966900502708377	825	796	14	15	3057971	3055003	1691	246712	58202	0.9994467879349389	0.9252776208727889	genomes
global_rank	syndip	RF	True	570	41.0	0.8889192580536899	0.8916594758027316	529	504	17	8	3058500	3055507	1708	246208	58185	0.999441321594981	0.9254302688148432	genomes
global_rank	syndip	RF	True	574	42.0	0.8849148525887564	0.8889133149329714	520	498	10	12	3059020	3056005	1718	245710	58175	0.9994381440045419	0.9255810995194922	genomes
global_rank	syndip	RF	True	578	43.0	0.8814600397640442	0.8848835780839663	343	329	8	6	3059363	3056334	1726	245381	58167	0.9994355898837826	0.9256807447038887	genomes
global_rank	syndip	RF	True	582	44.0	0.8760615480646716	0.8814495583733839	544	517	11	16	3059907	3056851	1737	244864	58156	0.9994320908863829	0.9258373299936549	genomes
global_rank	syndip	RF	True	586	45.0	0.8691112546085044	0.8760547195327478	1106	1036	25	45	3061013	3057887	1762	243828	58131	0.9994241169493625	0.9261511063189888	genomes
global_rank	syndip	RF	True	590	46.0	0.8645172956176758	0.8691019908235553	557	523	9	25	3061570	3058410	1771	243305	58122	0.9994212760617754	0.9263095088461603	genomes
global_rank	syndip	RF	True	594	47.0	0.8617776825161789	0.8644995379123734	579	559	5	15	3062149	3058969	1776	242746	58117	0.9994197491133695	0.9264788147977642	genomes
global_rank	syndip	RF	True	598	48.0	0.8587615796659068	0.8617457306624231	6660	6583	17	60	3068809	3065552	1793	236163	58100	0.9994154553856837	0.9284726271043988	genomes
global_rank	syndip	RF	True	602	49.0	0.8564611965972356	0.8587466298007476	10197	10102	15	80	3079006	3075654	1808	226061	58085	0.9994125029001171	0.9315322491493058	genomes
global_rank	syndip	RF	True	606	50.0	0.8542885351945638	0.8564611965972356	4406	4343	11	52	3083412	3079997	1819	221718	58074	0.999409763593933	0.9328476261579209	genomes
global_rank	syndip	RF	True	610	51.0	0.8518990555831976	0.8542884279607608	28838	28652	28	158	3112250	3108649	1847	193066	58046	0.9994062040266247	0.9415255405145507	genomes
global_rank	syndip	RF	True	614	52.0	0.8497533553422173	0.851886658416599	2181	2089	20	72	3114431	3110738	1867	190977	58026	0.9994001808774322	0.942158242004534	genomes
global_rank	syndip	RF	True	618	53.0	0.8474455868047347	0.8497309013803638	38130	37684	186	260	3152561	3148422	2053	153293	57840	0.9993483522325999	0.9535717044021061	genomes
global_rank	syndip	RF	True	622	54.0	0.844780830990976	0.8474397747277549	17717	17524	88	105	3170278	3165946	2141	135769	57752	0.9993241978518898	0.9588792491175041	genomes
global_rank	syndip	RF	True	626	55.0	0.84205237553352	0.8447602596503165	3649	3591	12	46	3173927	3169537	2153	132178	57740	0.9993211820827382	0.9599668657046414	genomes
global_rank	syndip	RF	True	630	56.0	0.8394808120110454	0.8420383854312276	1168	1094	17	57	3175095	3170631	2170	131084	57723	0.9993160617385081	0.9602982086582276	genomes
global_rank	syndip	RF	True	634	57.0	0.8364533089057747	0.8394755773431052	1967	1816	40	111	3177062	3172447	2210	129268	57683	0.9993038618030231	0.9608482258462647	genomes
global_rank	syndip	RF	True	638	58.0	0.8326013744154694	0.8364487442183428	4051	3814	65	172	3181113	3176261	2275	125454	57618	0.9992842616852539	0.9620033830903031	genomes
global_rank	syndip	RF	True	642	59.0	0.8285064753703886	0.8325847036124154	2300	2212	21	67	3183413	3178473	2296	123242	57597	0.9992781619790686	0.9626733379470972	genomes
global_rank	syndip	RF	True	646	60.0	0.823696026112401	0.8284609853056983	3112	2991	36	85	3186525	3181464	2332	120251	57561	0.9992675410107934	0.9635792307936936	genomes
global_rank	syndip	RF	True	650	61.0	0.8188003936922281	0.8236753958224542	5034	4882	34	118	3191559	3186346	2366	115369	57527	0.9992580076218862	0.9650578562958947	genomes
global_rank	syndip	RF	True	654	62.0	0.8141267836457498	0.8187893830733969	4170	3939	65	166	3195729	3190285	2431	111430	57462	0.9992385793161684	0.9662508726525457	genomes
global_rank	syndip	RF	True	658	63.0	0.8108500389707488	0.8141227739577237	2293	2121	70	102	3198022	3192406	2501	109309	57392	0.9992171916115242	0.9668932660753579	genomes
global_rank	syndip	RF	True	662	64.0	0.8060347772133308	0.8108401937100658	2592	2230	177	185	3200614	3194636	2678	107079	57215	0.9991624219579309	0.9675686726443682	genomes
global_rank	syndip	RF	True	666	65.0	0.8018643475938343	0.8060296965311261	1593	1437	39	117	3202207	3196073	2717	105642	57176	0.9991506163267986	0.9680039010029636	genomes
global_rank	syndip	RF	True	670	66.0	0.795968919363091	0.8018577543873981	1489	1374	24	91	3203696	3197447	2741	104268	57152	0.9991434878200905	0.9684200483688022	genomes
global_rank	syndip	RF	True	674	67.0	0.7904354065194834	0.7959360529166701	960	861	19	80	3204656	3198308	2760	103407	57133	0.999137787763334	0.9686808219364784	genomes
global_rank	syndip	RF	True	678	68.0	0.7843112403714904	0.790427622704001	846	750	29	67	3205502	3199058	2789	102657	57104	0.9991289402647909	0.9689079766121546	genomes
global_rank	syndip	RF	True	682	69.0	0.7785881456388952	0.78428849311754	1362	1239	23	100	3206864	3200297	2812	101418	57081	0.9991221029318702	0.9692832361363716	genomes
global_rank	syndip	RF	True	686	70.0	0.7715298025251621	0.778560996342819	1330	1150	32	148	3208194	3201447	2844	100268	57049	0.9991124401622699	0.9696315399724083	genomes
global_rank	syndip	RF	True	690	71.0	0.763234617635793	0.7715095868175077	2192	1962	76	154	3210386	3203409	2920	98306	56973	0.9990893011914872	0.970225776603977	genomes
global_rank	syndip	RF	True	694	72.0	0.753640317567298	0.7632023816632252	2292	2152	46	94	3212678	3205561	2966	96154	56927	0.999075588268386	0.970877559086717	genomes
global_rank	syndip	RF	True	698	73.0	0.7419567795353533	0.7536086800560958	1492	1339	38	115	3214170	3206900	3004	94815	56889	0.9990641464666856	0.9712831059010242	genomes
global_rank	syndip	RF	True	702	74.0	0.7304441365873756	0.7419539461544759	3100	2815	53	232	3217270	3209715	3057	92000	56836	0.9990484852333126	0.9721356931170619	genomes
global_rank	syndip	RF	True	706	75.0	0.721828004044095	0.7304204620671411	1900	1637	63	200	3219170	3211352	3120	90363	56773	0.9990293895855992	0.9726314960558377	genomes
global_rank	syndip	RF	True	710	76.0	0.7087857241867713	0.7218198552044225	2560	2221	85	254	3221730	3213573	3205	88142	56688	0.999003661427677	0.9733041767687399	genomes
global_rank	syndip	RF	True	714	77.0	0.6881189532099972	0.7087693753501989	2166	1759	101	306	3223896	3215332	3306	86383	56587	0.9989728574633121	0.9738369302014256	genomes
global_rank	syndip	RF	True	718	78.0	0.6673548249289664	0.6880856990695934	1716	1332	99	285	3225612	3216664	3405	85051	56488	0.9989425692430814	0.9742403569054264	genomes
global_rank	syndip	RF	True	722	79.0	0.6494401001262936	0.6672927020527368	1479	1230	62	187	3227091	3217894	3467	83821	56426	0.9989237468262638	0.9746128905735353	genomes
global_rank	syndip	RF	True	726	80.0	0.6303424982940352	0.6494144061138615	1713	1333	127	253	3228804	3219227	3594	82488	56299	0.9988848279193911	0.975016620150437	genomes
global_rank	syndip	RF	True	730	81.0	0.614301883096098	0.6303130574425225	1959	1585	135	239	3230763	3220812	3729	80903	56164	0.9988435563387161	0.9754966736983659	genomes
global_rank	syndip	RF	True	734	82.0	0.5952798738672921	0.6142667638682995	1302	951	151	200	3232065	3221763	3880	79952	56013	0.9987971390510357	0.9757847058271232	genomes
global_rank	syndip	RF	True	738	83.0	0.5687630594883576	0.5952695208797762	1812	1380	121	311	3233877	3223143	4001	78572	55892	0.9987602040689848	0.9762026704303672	genomes
global_rank	syndip	RF	True	742	84.0	0.5304914978518209	0.5687630594883576	14254	13444	276	534	3248131	3236587	4277	65128	55616	0.9986802901942198	0.980274493710087	genomes
global_rank	syndip	RF	True	746	85.0	0.4360544172558921	0.5304449082305932	16908	12915	2940	1053	3265039	3249502	7217	52213	52676	0.9977839660099628	0.9841860972252299	genomes
global_rank	syndip	RF	True	750	86.0	0.33056868290922503	0.43601188562648596	6698	3991	2000	707	3271737	3253493	9217	48222	50676	0.9971750477363909	0.9853948629727278	genomes
global_rank	syndip	RF	True	754	87.0	0.3047973422682716	0.3305465072618182	1311	652	492	167	3273048	3254145	9709	47570	50184	0.9970252958618859	0.9855923361041156	genomes
global_rank	syndip	RF	True	758	88.0	0.2826681786245671	0.3045635528946622	994	500	365	129	3274042	3254645	10074	47070	49819	0.9969142826687382	0.9857437725545664	genomes
global_rank	syndip	RF	True	762	89.0	0.26348397283032465	0.2826520213315668	1399	835	314	250	3275441	3255480	10388	46235	49505	0.9968192223323171	0.9859966714268191	genomes
global_rank	syndip	RF	True	766	90.0	0.2437356780379878	0.26344536341468566	1793	1104	269	420	3277234	3256584	10657	45131	49236	0.9967382265342533	0.9863310431094143	genomes
global_rank	syndip	RF	True	770	91.0	0.2148070259753231	0.24366109362314484	4415	2663	280	1472	3281649	3259247	10937	42468	48956	0.9966555398717626	0.987137593644515	genomes
global_rank	syndip	RF	True	774	92.0	0.17482492047798065	0.2147517076002831	4149	2268	560	1321	3285798	3261515	11497	40200	48396	0.9964873333797737	0.9878245093837597	genomes
global_rank	syndip	RF	True	778	93.0	0.11458716681579477	0.1747895763343642	4794	2083	1432	1279	3290592	3263598	12929	38117	46964	0.9960540535756306	0.9884553936363375	genomes
global_rank	syndip	RF	True	782	94.0	0.0689495206979114	0.11455636335577987	4885	1147	2927	811	3295477	3264745	15856	36970	44037	0.995166739265153	0.9888027888536715	genomes
global_rank	syndip	RF	True	786	95.0	0.0364941342505222	0.06893790606132535	5924	624	4472	828	3301401	3265369	20328	36346	39565	0.9938131848432767	0.988991781543834	genomes
global_rank	syndip	RF	True	790	96.0	0.022669118094966228	0.03648905211180374	3825	195	3425	205	3305226	3265564	23753	36151	36140	0.992778744037136	0.9890508417595099	genomes
global_rank	syndip	RF	True	794	97.0	0.011211154696240386	0.022664707036422496	6809	137	6452	220	3312035	3265701	30205	36014	29688	0.9908356002871441	0.9890923353469333	genomes
global_rank	syndip	RF	True	798	98.0	0.005281140484350491	0.011198902934019477	9865	57	9728	80	3321900	3265758	39933	35957	19960	0.9879199235500232	0.9891095991022847	genomes
global_rank	syndip	RF	True	802	99.0	0.0014067156666908416	0.005281140484350491	11386	32	11319	35	3333286	3265790	51252	35925	8641	0.9845488842167208	0.9891192910351135	genomes
global_rank	syndip	RF	True	808	-1.0	-1.0	-1.0	28322	11192	8641	8489	3361608	3276982	59893	24733	0	0.9820511706312044	0.9925090445420032	genomes
global_rank	syndip	VQSR	False	3	0.0	7.06	93.56	42071	41505	504	62	42071	41505	504	111511	18308	0.9880025708776691	0.2712461441940712	genomes
global_rank	syndip	VQSR	False	7	1.0	6.42	7.06	17460	17059	349	52	59531	58564	853	94452	17959	0.9856438393052493	0.38273121765044177	genomes
global_rank	syndip	VQSR	False	11	2.0	5.72	6.42	17179	15709	1345	125	76710	74273	2198	78743	16614	0.971257077846504	0.48539368432059393	genomes
global_rank	syndip	VQSR	False	15	3.0	5.26	5.72	9232	8219	946	67	85942	82492	3144	70524	15668	0.963286468307721	0.539107021487949	genomes
global_rank	syndip	VQSR	False	19	4.0	4.87	5.26	5470	4802	590	78	91412	87294	3734	65722	15078	0.9589796546117678	0.5704893605897422	genomes
global_rank	syndip	VQSR	False	23	5.0	4.52	4.87	4007	3544	402	61	95419	90838	4136	62178	14676	0.9564512392865416	0.5936503372196371	genomes
global_rank	syndip	VQSR	False	27	6.0	4.16	4.52	3334	2948	323	63	98753	93786	4459	59230	14353	0.9546134663341646	0.6129162963350238	genomes
global_rank	syndip	VQSR	False	31	7.0	3.78	4.16	3174	2815	297	62	101927	96601	4756	56415	14056	0.953076748522549	0.6313130653003608	genomes
global_rank	syndip	VQSR	False	35	8.0	3.42	3.78	3317	2956	290	71	105244	99557	5046	53459	13766	0.9517604657610202	0.6506313065300361	genomes
global_rank	syndip	VQSR	False	39	9.0	3.11	3.42	3862	3433	350	79	109106	102990	5396	50026	13416	0.9502149724134114	0.6730668688241752	genomes
global_rank	syndip	VQSR	False	43	10.0	2.82	3.11	3341	2936	319	86	112447	105926	5715	47090	13097	0.9488091292625469	0.6922544047681288	genomes
global_rank	syndip	VQSR	False	47	11.0	2.53	2.82	2957	2569	300	88	115404	108495	6015	44521	12797	0.9474718365208279	0.7090434987190882	genomes
global_rank	syndip	VQSR	False	51	12.0	2.26	2.53	2543	2153	307	83	117947	110648	6322	42368	12490	0.9459519534923485	0.7231139227270351	genomes
global_rank	syndip	VQSR	False	55	13.0	2.02	2.26	2274	1855	335	84	120221	112503	6657	40513	12155	0.9441339375629406	0.7352368379777278	genomes
global_rank	syndip	VQSR	False	59	14.0	1.79	2.02	2342	1829	411	102	122563	114332	7068	38684	11744	0.9417792421746293	0.7471898363569823	genomes
global_rank	syndip	VQSR	False	63	15.0	1.59	1.79	2162	1647	423	92	124725	115979	7491	37037	11321	0.9393293917550822	0.7579534166361688	genomes
global_rank	syndip	VQSR	False	67	16.0	1.41	1.59	1910	1431	366	113	126635	117410	7857	35606	10955	0.9372779742470084	0.7673053798295603	genomes
global_rank	syndip	VQSR	False	71	17.0	1.25	1.41	1642	1194	332	116	128277	118604	8189	34412	10623	0.9354144156223135	0.775108485387149	genomes
global_rank	syndip	VQSR	False	75	18.0	1.11	1.25	1434	1004	314	116	129711	119608	8503	33408	10309	0.933627869581847	0.7816698907303812	genomes
global_rank	syndip	VQSR	False	79	19.0	0.981	1.11	1130	807	229	94	130841	120415	8732	32601	10080	0.9323871247493166	0.786943849009254	genomes
global_rank	syndip	VQSR	False	83	20.0	0.868	0.981	986	672	226	88	131827	121087	8958	31929	9854	0.9311161521011957	0.7913355466095049	genomes
global_rank	syndip	VQSR	False	87	21.0	0.767	0.868	853	560	208	85	132680	121647	9166	31369	9646	0.929930511493506	0.794995294609714	genomes
global_rank	syndip	VQSR	False	91	22.0	0.675	0.766	827	544	202	81	133507	122191	9368	30825	9444	0.9287924049285872	0.7985504783813457	genomes
global_rank	syndip	VQSR	False	95	23.0	0.591	0.674	661	452	155	54	134168	122643	9523	30373	9289	0.9279466731231936	0.8015044178386574	genomes
global_rank	syndip	VQSR	False	99	24.0	0.513	0.591	600	393	145	62	134768	123036	9668	29980	9144	0.9271461297323367	0.8040727767030899	genomes
global_rank	syndip	VQSR	False	103	25.0	0.439	0.513	503	333	118	52	135271	123369	9786	29647	9026	0.9265067027148811	0.8062490197103571	genomes
global_rank	syndip	VQSR	False	107	26.0	0.368	0.439	482	303	124	55	135753	123672	9910	29344	8902	0.9258133580871675	0.8082292047890417	genomes
global_rank	syndip	VQSR	False	111	27.0	0.297	0.367	445	286	98	61	136198	123958	10008	29058	8804	0.9252944777032979	0.8100982903748628	genomes
global_rank	syndip	VQSR	False	115	28.0	0.227	0.297	428	271	108	49	136626	124229	10116	28787	8696	0.924701328668726	0.8118693469963926	genomes
global_rank	syndip	VQSR	False	119	29.0	0.155	0.226	363	245	65	53	136989	124474	10181	28542	8631	0.9243919646504029	0.813470486746484	genomes
global_rank	syndip	VQSR	False	123	30.0	0.081	0.155	375	226	98	51	137364	124700	10279	28316	8533	0.9238474133013284	0.8149474564751399	genomes
global_rank	syndip	VQSR	False	127	31.0	0.0055	0.081	401	242	106	53	137765	124942	10385	28074	8427	0.9232599555151596	0.816528990432373	genomes
global_rank	syndip	VQSR	False	131	32.0	-0.0706	0.0053	424	253	105	66	138189	125195	10490	27821	8322	0.9226885801672993	0.8181824122967533	genomes
global_rank	syndip	VQSR	False	135	33.0	-0.1465	-0.0708	389	242	79	68	138578	125437	10569	27579	8243	0.922290193079717	0.8197639462539865	genomes
global_rank	syndip	VQSR	False	139	34.0	-0.2202	-0.1467	363	206	98	59	138941	125643	10667	27373	8145	0.9217445528574573	0.8211102106969206	genomes
global_rank	syndip	VQSR	False	143	35.0	-0.2901	-0.2206	346	198	79	69	139287	125841	10746	27175	8066	0.9213248698631641	0.822404193025566	genomes
global_rank	syndip	VQSR	False	147	36.0	-0.3555	-0.2906	328	192	82	54	139615	126033	10828	26983	7984	0.9208832318922118	0.8236589637684948	genomes
global_rank	syndip	VQSR	False	151	37.0	-0.417	-0.3557	325	175	80	70	139940	126208	10908	26808	7904	0.9204469208553342	0.8248026350185601	genomes
global_rank	syndip	VQSR	False	155	38.0	-0.4762	-0.4175	295	157	78	60	140235	126365	10986	26651	7826	0.9200151436829728	0.8258286715114759	genomes
global_rank	syndip	VQSR	False	159	39.0	-0.5331	-0.4769	321	156	91	74	140556	126521	11077	26495	7735	0.9194973764153549	0.8268481727401056	genomes
global_rank	syndip	VQSR	False	163	40.0	-0.5887	-0.5333	306	170	67	69	140862	126691	11144	26325	7668	0.9191497079841839	0.8279591676687406	genomes
global_rank	syndip	VQSR	False	167	41.0	-0.6438	-0.5889	339	155	116	68	141201	126846	11260	26170	7552	0.918468422805671	0.8289721336330841	genomes
global_rank	syndip	VQSR	False	171	42.0	-0.698	-0.6444	331	165	97	69	141532	127011	11357	26005	7455	0.9179217738205365	0.8300504522402886	genomes
global_rank	syndip	VQSR	False	175	43.0	-0.7531	-0.6985	320	134	109	77	141852	127145	11466	25871	7346	0.9172792924082505	0.8309261776546244	genomes
global_rank	syndip	VQSR	False	179	44.0	-0.8072	-0.7532	314	158	87	69	142166	127303	11553	25713	7259	0.9167986979316702	0.8319587494118262	genomes
global_rank	syndip	VQSR	False	183	45.0	-0.8621	-0.8076	314	169	79	66	142480	127472	11632	25544	7180	0.916379112031286	0.833063209076175	genomes
global_rank	syndip	VQSR	False	187	46.0	-0.9171	-0.8624	301	148	88	65	142781	127620	11720	25396	7092	0.9158891919046935	0.834030428190516	genomes
global_rank	syndip	VQSR	False	191	47.0	-0.973	-0.9183	308	145	81	82	143089	127765	11801	25251	7011	0.9154450224266655	0.8349780415119987	genomes
global_rank	syndip	VQSR	False	195	48.0	-1.029	-0.9731	301	137	89	75	143390	127902	11890	25114	6922	0.9149450612338331	0.8358733727191927	genomes
global_rank	syndip	VQSR	False	199	49.0	-1.086	-1.029	303	142	88	73	143693	128044	11978	24972	6834	0.9144562997243291	0.8368013802478173	genomes
global_rank	syndip	VQSR	False	203	50.0	-1.143	-1.087	318	132	109	77	144011	128176	12087	24840	6725	0.913826169410322	0.8376640351335808	genomes
global_rank	syndip	VQSR	False	207	51.0	-1.2	-1.143	308	138	98	72	144319	128314	12185	24702	6627	0.9132734040811679	0.838565901605061	genomes
global_rank	syndip	VQSR	False	211	52.0	-1.256	-1.2	299	141	87	71	144618	128455	12272	24561	6540	0.912795696632487	0.8394873738693993	genomes
global_rank	syndip	VQSR	False	215	53.0	-1.313	-1.257	220	110	66	44	144838	128565	12338	24451	6474	0.9124362149847768	0.8402062529408689	genomes
global_rank	syndip	VQSR	False	219	54.0	-1.369	-1.313	259	134	57	68	145097	128699	12395	24317	6417	0.9121507647384014	0.8410819783552047	genomes
global_rank	syndip	VQSR	False	223	55.0	-1.424	-1.369	235	114	64	57	145332	128813	12459	24203	6353	0.9118084262982049	0.8418269984838187	genomes
global_rank	syndip	VQSR	False	227	56.0	-1.478	-1.424	260	118	85	57	145592	128931	12544	24085	6268	0.9113341579784414	0.8425981596695771	genomes
global_rank	syndip	VQSR	False	231	57.0	-1.531	-1.478	216	101	67	48	145808	129032	12611	23984	6201	0.9109663026058471	0.8432582213624719	genomes
global_rank	syndip	VQSR	False	235	58.0	-1.582	-1.531	228	105	69	54	146036	129137	12680	23879	6132	0.9105889984980644	0.8439444241125111	genomes
global_rank	syndip	VQSR	False	239	59.0	-1.631	-1.582	199	95	61	43	146235	129232	12741	23784	6071	0.9102575841885429	0.8445652742196894	genomes
global_rank	syndip	VQSR	False	243	60.0	-1.68	-1.632	215	94	83	38	146450	129326	12824	23690	5988	0.9097854379176926	0.8451795890625817	genomes
global_rank	syndip	VQSR	False	247	61.0	-1.726	-1.681	183	101	47	35	146633	129427	12871	23589	5941	0.9095489746869246	0.8458396507554765	genomes
global_rank	syndip	VQSR	False	251	62.0	-1.771	-1.727	180	81	57	42	146813	129508	12928	23508	5884	0.9092364289926704	0.8463690071626496	genomes
global_rank	syndip	VQSR	False	255	63.0	-1.815	-1.772	153	74	47	32	146966	129582	12975	23434	5837	0.9089837749110882	0.8468526167198202	genomes
global_rank	syndip	VQSR	False	259	64.0	-1.856	-1.815	198	95	67	36	147164	129677	13042	23339	5770	0.908617633251354	0.8474734668269985	genomes
global_rank	syndip	VQSR	False	263	65.0	-1.897	-1.857	151	75	48	28	147315	129752	13090	23264	5722	0.9083602861903362	0.847963611648455	genomes
global_rank	syndip	VQSR	False	267	66.0	-1.937	-1.898	166	73	54	39	147481	129825	13144	23191	5668	0.908063985899041	0.8484406859413395	genomes
global_rank	syndip	VQSR	False	271	67.0	-1.977	-1.938	183	95	57	31	147664	129920	13201	23096	5611	0.9077633610720999	0.8490615360485178	genomes
global_rank	syndip	VQSR	False	275	68.0	-2.017	-1.978	133	66	38	29	147797	129986	13239	23030	5573	0.9075650200733112	0.8494928634913996	genomes
global_rank	syndip	VQSR	False	279	69.0	-2.055	-2.017	143	59	45	39	147940	130045	13284	22971	5528	0.9073181282224811	0.8498784440842788	genomes
global_rank	syndip	VQSR	False	283	70.0	-2.094	-2.056	144	64	45	35	148084	130109	13329	22907	5483	0.9070748337260698	0.8502967009985883	genomes
global_rank	syndip	VQSR	False	287	71.0	-2.133	-2.094	134	71	39	24	148218	130180	13368	22836	5444	0.9068743556162399	0.8507607047629007	genomes
global_rank	syndip	VQSR	False	291	72.0	-2.173	-2.134	105	41	42	22	148323	130221	13410	22795	5402	0.9066357541199324	0.8510286505986302	genomes
global_rank	syndip	VQSR	False	295	73.0	-2.213	-2.173	129	65	35	29	148452	130286	13445	22730	5367	0.90645720129965	0.8514534427772259	genomes
global_rank	syndip	VQSR	False	299	74.0	-2.256	-2.214	132	63	43	26	148584	130349	13488	22667	5324	0.9062271877194324	0.8518651644272495	genomes
global_rank	syndip	VQSR	False	303	75.0	-2.301	-2.257	139	66	49	24	148723	130415	13537	22601	5275	0.9059617094587085	0.8522964918701312	genomes
global_rank	syndip	VQSR	False	307	76.0	-2.349	-2.302	137	67	38	32	148860	130482	13575	22534	5237	0.9057664674399717	0.8527343545772991	genomes
global_rank	syndip	VQSR	False	311	77.0	-2.399	-2.349	127	57	42	28	148987	130539	13617	22477	5195	0.9055398318488305	0.8531068646416061	genomes
global_rank	syndip	VQSR	False	315	78.0	-2.451	-2.399	133	57	56	20	149120	130596	13673	22420	5139	0.9052256548530869	0.8534793747059131	genomes
global_rank	syndip	VQSR	False	319	79.0	-2.507	-2.452	155	67	51	37	149275	130663	13724	22353	5088	0.9049498916107406	0.853917237413081	genomes
global_rank	syndip	VQSR	False	323	80.0	-2.565	-2.508	157	71	57	29	149432	130734	13781	22282	5031	0.9046396567830329	0.8543812411773932	genomes
global_rank	syndip	VQSR	False	327	81.0	-2.628	-2.566	141	63	53	25	149573	130797	13834	22219	4978	0.9043496899005055	0.8547929628274168	genomes
global_rank	syndip	VQSR	False	331	82.0	-2.697	-2.629	151	71	51	29	149724	130868	13885	22148	4927	0.9040779811126539	0.855256966591729	genomes
global_rank	syndip	VQSR	False	335	83.0	-2.772	-2.697	187	70	79	38	149911	130938	13964	22078	4848	0.9036314198561787	0.8557144350917552	genomes
global_rank	syndip	VQSR	False	339	84.0	-2.856	-2.772	185	79	71	35	150096	131017	14035	21999	4777	0.9032415961172545	0.856230720970356	genomes
global_rank	syndip	VQSR	False	343	85.0	-2.951	-2.856	218	94	83	41	150314	131111	14118	21905	4694	0.9027880106590281	0.8568450358132483	genomes
global_rank	syndip	VQSR	False	347	86.0	-3.063	-2.953	171	67	71	33	150485	131178	14189	21838	4623	0.9023918771110362	0.8572828985204162	genomes
global_rank	syndip	VQSR	False	351	87.0	-3.198	-3.065	250	100	107	43	150735	131278	14296	21738	4516	0.9017956503221729	0.8579364249490249	genomes
global_rank	syndip	VQSR	False	355	88.0	-3.363	-3.198	250	101	98	51	150985	131379	14394	21637	4418	0.901257434504332	0.8585964866419198	genomes
global_rank	syndip	VQSR	False	359	89.0	-3.575	-3.365	301	105	156	40	151286	131484	14550	21532	4262	0.9003656682690332	0.8592826893919591	genomes
global_rank	syndip	VQSR	False	363	90.0	-3.862	-3.577	356	131	179	46	151642	131615	14729	21401	4083	0.8993535778713169	0.8601388090134365	genomes
global_rank	syndip	VQSR	False	367	91.0	-4.296	-3.867	434	165	210	59	152076	131780	14939	21236	3873	0.8981795132191468	0.861217127620641	genomes
global_rank	syndip	VQSR	False	371	92.0	-5.012	-4.297	550	186	315	49	152626	131966	15254	21050	3558	0.8963863605488385	0.8624326867778533	genomes
global_rank	syndip	VQSR	False	375	93.0	-6.242	-5.016	539	183	303	53	153165	132149	15557	20867	3255	0.8946759102541535	0.8636286401422073	genomes
global_rank	syndip	VQSR	False	379	94.0	-8.236	-6.248	373	69	266	38	153538	132218	15823	20798	2989	0.8931174471936828	0.8640795733779474	genomes
global_rank	syndip	VQSR	False	383	95.0	-11.17	-8.24	290	23	245	22	153828	132241	16068	20775	2744	0.8916586316406961	0.8642298844565274	genomes
global_rank	syndip	VQSR	False	387	96.0	-14.95	-11.18	270	17	243	10	154098	132258	16311	20758	2501	0.8902126284756577	0.864340983949391	genomes
global_rank	syndip	VQSR	False	391	97.0	-21.48	-15.02	330	16	299	15	154428	132274	16610	20742	2202	0.8884366352327987	0.8644455481779684	genomes
global_rank	syndip	VQSR	False	395	98.0	-35.1	-21.51	282	10	265	7	154710	132284	16875	20732	1937	0.8868656936557633	0.8645109008208292	genomes
global_rank	syndip	VQSR	False	399	99.0	-23560.0	-35.23	2009	151	1801	57	156719	132435	18676	20581	136	0.8764087326534798	0.8654977257280284	genomes
global_rank	syndip	VQSR	False	403	-1.0	-1.0	-1.0	15109	290	136	14683	171828	132725	18812	20291	0	0.8758587011752905	0.8673929523709939	genomes
global_rank	syndip	VQSR	True	407	0.0	21.46	131.12	1416163	1415595	521	47	1416163	1415595	521	1886120	59372	0.9996320922862252	0.4287453641516606	genomes
global_rank	syndip	VQSR	True	411	1.0	20.88	21.46	556261	556106	126	29	1972424	1971701	647	1330014	59246	0.9996719645823151	0.5971748015803908	genomes
global_rank	syndip	VQSR	True	415	2.0	20.47	20.88	228042	227941	84	17	2200466	2199642	731	1102073	59162	0.999667783598508	0.6662119534847799	genomes
global_rank	syndip	VQSR	True	419	3.0	19.95	20.47	155186	155057	100	29	2355652	2354699	831	947016	59062	0.9996472131537276	0.713174516879864	genomes
global_rank	syndip	VQSR	True	423	4.0	19.19	19.95	181914	181721	154	39	2537566	2536420	985	765295	58908	0.9996118081268067	0.7682128833045856	genomes
global_rank	syndip	VQSR	True	427	5.0	18.49	19.19	132166	131919	178	69	2669732	2668339	1163	633376	58730	0.9995643382173903	0.8081675735186108	genomes
global_rank	syndip	VQSR	True	431	6.0	18.15	18.49	54747	54636	76	35	2724479	2722975	1239	578740	58654	0.9995451899153297	0.8247153373322652	genomes
global_rank	syndip	VQSR	True	435	7.0	17.79	18.15	45613	45477	103	33	2770092	2768452	1342	533263	58551	0.9995154874333615	0.8384890882465628	genomes
global_rank	syndip	VQSR	True	439	8.0	17.35	17.79	44255	44106	106	43	2814347	2812558	1448	489157	58445	0.9994854310900545	0.8518476004137244	genomes
global_rank	syndip	VQSR	True	443	9.0	16.95	17.35	39758	39616	99	43	2854105	2852174	1547	449541	58346	0.999457900754839	0.8638462132558382	genomes
global_rank	syndip	VQSR	True	447	10.0	16.61	16.95	26859	26747	75	37	2880964	2878921	1622	422794	58271	0.9994369117211581	0.8719471547362507	genomes
global_rank	syndip	VQSR	True	451	11.0	16.32	16.61	19026	18926	72	28	2899990	2897847	1694	403868	58199	0.9994157695993953	0.8776793272587126	genomes
global_rank	syndip	VQSR	True	455	12.0	16.04	16.32	10944	10846	72	26	2910934	2908693	1766	393022	58127	0.9993932228559138	0.8809642867418902	genomes
global_rank	syndip	VQSR	True	459	13.0	15.8	16.04	6998	6910	60	28	2917932	2915603	1826	386112	58067	0.9993741064478348	0.8830571384871195	genomes
global_rank	syndip	VQSR	True	463	14.0	15.63	15.8	4470	4419	37	14	2922402	2920022	1863	381693	58030	0.9993623979040928	0.8843955338362033	genomes
global_rank	syndip	VQSR	True	467	15.0	15.49	15.63	3476	3426	34	16	2925878	2923448	1897	378267	57996	0.9993515294777198	0.8854331763946919	genomes
global_rank	syndip	VQSR	True	471	16.0	15.36	15.49	3044	3003	31	10	2928922	2926451	1928	375264	57965	0.9993416152758915	0.886342703716099	genomes
global_rank	syndip	VQSR	True	475	17.0	15.26	15.36	2581	2539	32	10	2931503	2928990	1960	372725	57933	0.9993312748426278	0.8871116980114879	genomes
global_rank	syndip	VQSR	True	479	18.0	15.16	15.26	2309	2270	27	12	2933812	2931260	1987	370455	57906	0.9993225936990645	0.8877992194965344	genomes
global_rank	syndip	VQSR	True	483	19.0	15.06	15.16	2182	2153	22	7	2935994	2933413	2009	368302	57884	0.9993156009595895	0.8884513048521753	genomes
global_rank	syndip	VQSR	True	487	20.0	14.98	15.06	2186	2153	25	8	2938180	2935566	2034	366149	57859	0.9993075980392156	0.8891033902078163	genomes
global_rank	syndip	VQSR	True	491	21.0	14.9	14.98	2162	2131	20	11	2940342	2937697	2054	364018	57839	0.9993013013687214	0.8897488123596373	genomes
global_rank	syndip	VQSR	True	495	22.0	14.82	14.9	2122	2101	16	5	2942464	2939798	2070	361917	57823	0.999296365438558	0.8903851483244314	genomes
global_rank	syndip	VQSR	True	499	23.0	14.75	14.82	2099	2068	27	4	2944563	2941866	2097	359849	57796	0.9992876948521432	0.8910114894834957	genomes
global_rank	syndip	VQSR	True	503	24.0	14.68	14.75	1973	1945	20	8	2946536	2943811	2117	357904	57776	0.9992813809434582	0.8916005772757492	genomes
global_rank	syndip	VQSR	True	507	25.0	14.61	14.68	1804	1777	21	6	2948340	2945588	2138	356127	57755	0.9992746951378791	0.892138782420651	genomes
global_rank	syndip	VQSR	True	511	26.0	14.55	14.61	1735	1718	13	4	2950075	2947306	2151	354409	57742	0.9992707132194163	0.8926591180643999	genomes
global_rank	syndip	VQSR	True	515	27.0	14.49	14.55	1752	1724	13	15	2951827	2949030	2164	352685	57729	0.999266737462871	0.8931812709455541	genomes
global_rank	syndip	VQSR	True	519	28.0	14.43	14.49	1571	1541	22	8	2953398	2950571	2186	351144	57707	0.9992596749410805	0.8936479980858433	genomes
global_rank	syndip	VQSR	True	523	29.0	14.38	14.43	1579	1552	17	10	2954977	2952123	2203	349592	57690	0.999254313843496	0.8941180568280424	genomes
global_rank	syndip	VQSR	True	527	30.0	14.33	14.38	1377	1349	17	11	2956354	2953472	2220	348243	57673	0.9992489068549768	0.8945266323713585	genomes
global_rank	syndip	VQSR	True	531	31.0	14.28	14.33	1329	1302	16	11	2957683	2954774	2236	346941	57657	0.9992438307614786	0.8949209728883323	genomes
global_rank	syndip	VQSR	True	535	32.0	14.23	14.28	1206	1186	10	10	2958889	2955960	2246	345755	57647	0.9992407560528239	0.8952801801488015	genomes
global_rank	syndip	VQSR	True	539	33.0	14.19	14.23	1136	1117	13	6	2960025	2957077	2259	344638	57634	0.9992366530870439	0.8956184891791085	genomes
global_rank	syndip	VQSR	True	543	34.0	14.14	14.19	1057	1038	13	6	2961082	2958115	2272	343600	57621	0.9992325327735867	0.8959328712502442	genomes
global_rank	syndip	VQSR	True	547	35.0	14.11	14.14	1001	977	14	10	2962083	2959092	2286	342623	57607	0.9992280620711034	0.8962287780744249	genomes
global_rank	syndip	VQSR	True	551	36.0	14.07	14.11	901	874	17	10	2962984	2959966	2303	341749	57590	0.9992225554127596	0.8964934889898128	genomes
global_rank	syndip	VQSR	True	555	37.0	14.04	14.07	823	805	12	6	2963807	2960771	2315	340944	57578	0.9992187199426544	0.8967373016750386	genomes
global_rank	syndip	VQSR	True	559	38.0	14.01	14.04	855	836	14	5	2964662	2961607	2329	340108	57564	0.9992142205499714	0.8969905034201923	genomes
global_rank	syndip	VQSR	True	563	39.0	13.97	14.01	711	692	11	8	2965373	2962299	2340	339416	57553	0.9992106964794027	0.897200091467616	genomes
global_rank	syndip	VQSR	True	567	40.0	13.94	13.97	772	756	15	1	2966145	2963055	2355	338660	57538	0.9992058433741035	0.8974290633806976	genomes
global_rank	syndip	VQSR	True	571	41.0	13.91	13.94	741	716	17	8	2966886	2963771	2372	337944	57521	0.9992003082791355	0.897645920377743	genomes
global_rank	syndip	VQSR	True	575	42.0	13.88	13.91	697	687	8	2	2967583	2964458	2380	337257	57513	0.999197799138342	0.8978539940606625	genomes
global_rank	syndip	VQSR	True	579	43.0	13.85	13.88	705	688	13	4	2968288	2965146	2393	336569	57500	0.999193607902036	0.8980623706164826	genomes
global_rank	syndip	VQSR	True	583	44.0	13.82	13.85	669	657	5	7	2968957	2965803	2398	335912	57495	0.9991921032302058	0.898261358112375	genomes
global_rank	syndip	VQSR	True	587	45.0	13.79	13.82	654	637	11	6	2969611	2966440	2409	335275	57484	0.9991885744273286	0.8984542881502492	genomes
global_rank	syndip	VQSR	True	591	46.0	13.76	13.79	631	622	9	0	2970242	2967062	2418	334653	57475	0.9991857160176193	0.8986426750946099	genomes
global_rank	syndip	VQSR	True	595	47.0	13.73	13.76	602	587	11	4	2970844	2967649	2429	334066	57464	0.9991821763603514	0.8988204614874391	genomes
global_rank	syndip	VQSR	True	599	48.0	13.7	13.73	632	618	9	5	2971476	2968267	2438	333448	57455	0.9991793193871489	0.8990076369401963	genomes
global_rank	syndip	VQSR	True	603	49.0	13.67	13.7	601	579	13	9	2972077	2968846	2451	332869	57442	0.9991751077054902	0.8991830003498182	genomes
global_rank	syndip	VQSR	True	607	50.0	13.64	13.67	611	584	18	9	2972688	2969430	2469	332285	57424	0.9991692180656206	0.8993598781239447	genomes
global_rank	syndip	VQSR	True	611	51.0	13.61	13.64	576	554	12	10	2973264	2969984	2481	331731	57412	0.9991653392050033	0.8995276697110441	genomes
global_rank	syndip	VQSR	True	615	52.0	13.58	13.61	571	543	22	6	2973835	2970527	2503	331188	57390	0.9991580979673935	0.8996921296962336	genomes
global_rank	syndip	VQSR	True	619	53.0	13.55	13.58	540	529	8	3	2974375	2971056	2511	330659	57382	0.9991555596359524	0.8998523494608105	genomes
global_rank	syndip	VQSR	True	623	54.0	13.52	13.55	549	524	21	4	2974924	2971580	2532	330135	57361	0.9991486534468104	0.900011054860883	genomes
global_rank	syndip	VQSR	True	627	55.0	13.49	13.52	536	513	16	7	2975460	2972093	2548	329622	57345	0.9991434260470423	0.9001664286590454	genomes
global_rank	syndip	VQSR	True	631	56.0	13.45	13.49	600	573	20	7	2976060	2972666	2568	329049	57325	0.9991368746122153	0.9003399748312619	genomes
global_rank	syndip	VQSR	True	635	57.0	13.42	13.45	605	586	15	4	2976665	2973252	2583	328463	57310	0.9991320083270746	0.9005174583511902	genomes
global_rank	syndip	VQSR	True	639	58.0	13.39	13.42	525	503	16	6	2977190	2973755	2599	327960	57294	0.9991267839779812	0.9006698034203436	genomes
global_rank	syndip	VQSR	True	643	59.0	13.35	13.39	581	547	23	11	2977771	2974302	2622	327413	57271	0.9991192250793101	0.9008354748971368	genomes
global_rank	syndip	VQSR	True	647	60.0	13.32	13.35	582	562	15	5	2978353	2974864	2637	326851	57256	0.9991143579800645	0.9010056894674434	genomes
global_rank	syndip	VQSR	True	651	61.0	13.28	13.32	570	540	21	9	2978923	2975404	2658	326311	57235	0.9991074732493817	0.9011692408339302	genomes
global_rank	syndip	VQSR	True	655	62.0	13.24	13.28	567	540	20	7	2979490	2975944	2678	325771	57215	0.9991009265358276	0.9013327922004171	genomes
global_rank	syndip	VQSR	True	659	63.0	13.2	13.24	552	522	18	12	2980042	2976466	2696	325249	57197	0.999095047533501	0.9014908918546877	genomes
global_rank	syndip	VQSR	True	663	64.0	13.15	13.2	615	577	25	13	2980657	2977043	2721	324672	57172	0.9990868404343431	0.9016656495185078	genomes
global_rank	syndip	VQSR	True	667	65.0	13.11	13.15	583	555	21	7	2981240	2977598	2742	324117	57151	0.9990799707415933	0.9018337439785081	genomes
global_rank	syndip	VQSR	True	671	66.0	13.06	13.11	613	586	18	9	2981853	2978184	2760	323531	57133	0.9990741188026343	0.9020112274984364	genomes
global_rank	syndip	VQSR	True	675	67.0	13.0	13.06	680	635	27	18	2982533	2978819	2787	322896	57106	0.9990652688517531	0.9022035517905088	genomes
global_rank	syndip	VQSR	True	679	68.0	12.95	13.0	689	657	26	6	2983222	2979476	2813	322239	57080	0.9990567647870477	0.9024025392864011	genomes
global_rank	syndip	VQSR	True	683	69.0	12.89	12.95	702	668	24	10	2983924	2980144	2837	321571	57056	0.9990489379583711	0.9026048583842033	genomes
global_rank	syndip	VQSR	True	687	70.0	12.82	12.89	712	672	32	8	2984636	2980816	2869	320899	57024	0.999038437368556	0.9028083889736092	genomes
global_rank	syndip	VQSR	True	691	71.0	12.75	12.82	752	701	34	17	2985388	2981517	2903	320198	56990	0.999027281682873	0.9030207028771411	genomes
global_rank	syndip	VQSR	True	695	72.0	12.68	12.75	740	690	29	21	2986128	2982207	2932	319508	56961	0.9990178011811175	0.9032296851787631	genomes
global_rank	syndip	VQSR	True	699	73.0	12.59	12.68	777	733	33	11	2986905	2982940	2965	318775	56928	0.9990070012274336	0.9034516910151239	genomes
global_rank	syndip	VQSR	True	703	74.0	12.49	12.59	801	740	39	22	2987706	2983680	3004	318035	56889	0.9989942022657904	0.9036758169617911	genomes
global_rank	syndip	VQSR	True	707	75.0	12.38	12.49	801	743	38	20	2988507	2984423	3042	317292	56851	0.998981745392833	0.9039008515271609	genomes
global_rank	syndip	VQSR	True	711	76.0	12.26	12.38	855	770	63	22	2989362	2985193	3105	316522	56788	0.9989609470006003	0.904134063660855	genomes
global_rank	syndip	VQSR	True	715	77.0	12.11	12.26	843	740	77	26	2990205	2985933	3182	315782	56711	0.998935470866795	0.9043581896075221	genomes
global_rank	syndip	VQSR	True	719	78.0	11.93	12.11	826	701	101	24	2991031	2986634	3283	315081	56610	0.9989019762087041	0.9045705035110541	genomes
global_rank	syndip	VQSR	True	723	79.0	11.7	11.93	692	604	66	22	2991723	2987238	3349	314477	56544	0.9988801529599373	0.9047534387431986	genomes
global_rank	syndip	VQSR	True	727	80.0	11.35	11.7	627	484	116	27	2992350	2987722	3465	313993	56428	0.9988415969981148	0.9049000292272349	genomes
global_rank	syndip	VQSR	True	731	81.0	10.58	11.35	636	426	173	37	2992986	2988148	3638	313567	56255	0.9987840039361104	0.905029053083019	genomes
global_rank	syndip	VQSR	True	735	82.0	3.51	10.58	21841	19809	1228	804	3014827	3007957	4866	293758	55027	0.9983849034609733	0.9110286623769768	genomes
global_rank	syndip	VQSR	True	739	83.0	-0.0262	3.51	121938	118262	1549	2127	3136765	3126219	6415	175496	53478	0.9979522025234994	0.9468470173833902	genomes
global_rank	syndip	VQSR	True	743	84.0	-0.8501	-0.0262	37893	36094	800	999	3174658	3162313	7215	139402	52678	0.9977236358221161	0.9577789118685289	genomes
global_rank	syndip	VQSR	True	747	85.0	-1.365	-0.8501	9320	8013	575	732	3183978	3170326	7790	131389	52103	0.9975488622819305	0.9602058324234527	genomes
global_rank	syndip	VQSR	True	751	86.0	-1.734	-1.365	5332	4615	389	328	3189310	3174941	8179	126774	51714	0.9974305084319787	0.9616035908611131	genomes
global_rank	syndip	VQSR	True	755	87.0	-2.039	-1.734	3836	3319	315	202	3193146	3178260	8494	123455	51399	0.9973345918762477	0.9626088260192052	genomes
global_rank	syndip	VQSR	True	759	88.0	-2.384	-2.039	3704	3129	359	216	3196850	3181389	8853	120326	51040	0.997224975409389	0.963556515326126	genomes
global_rank	syndip	VQSR	True	763	89.0	-2.829	-2.384	4012	3416	425	171	3200862	3184805	9278	116910	50615	0.9970952539429939	0.9645911291556055	genomes
global_rank	syndip	VQSR	True	767	90.0	-3.447	-2.83	4608	3949	489	170	3205470	3188754	9767	112961	50126	0.9969464011647884	0.9657871742412655	genomes
global_rank	syndip	VQSR	True	771	91.0	-4.311	-3.447	5752	4858	732	162	3211222	3193612	10499	108103	49394	0.9967232720714108	0.967258530793845	genomes
global_rank	syndip	VQSR	True	775	92.0	-5.544	-4.311	6996	5721	1105	170	3218218	3199333	11604	102382	48289	0.9963861016270329	0.9689912666599025	genomes
global_rank	syndip	VQSR	True	779	93.0	-7.355	-5.544	9099	7110	1791	198	3227317	3206443	13395	95272	46498	0.9958398528124707	0.9711446929853121	genomes
global_rank	syndip	VQSR	True	783	94.0	-10.34	-7.355	12887	10224	2382	281	3240204	3216667	15777	85048	44116	0.9951191729848994	0.9742412655241292	genomes
global_rank	syndip	VQSR	True	787	95.0	-15.31	-10.34	17976	15024	2591	361	3258180	3231691	18368	70024	41525	0.9943484102903978	0.9787916279872733	genomes
global_rank	syndip	VQSR	True	791	96.0	-22.96	-15.31	20307	17083	2605	619	3278487	3248774	20973	52941	38920	0.9935857422607927	0.9839656057533737	genomes
global_rank	syndip	VQSR	True	795	97.0	-36.55	-22.97	12404	7963	2896	1545	3290891	3256737	23869	44978	36024	0.9927242101002071	0.9863773826632523	genomes
global_rank	syndip	VQSR	True	799	98.0	-73.64	-36.55	8440	3371	2906	2163	3299331	3260108	26775	41607	33118	0.9918539844588323	0.9873983672121912	genomes
global_rank	syndip	VQSR	True	803	99.0	-210600.0	-73.67	34008	5715	24496	3797	3333339	3265823	51271	35892	8622	0.9845433985289533	0.9891292858408434	genomes
global_rank	syndip	VQSR	True	805	100.0	-1.0	-1.0	4	0	4	0	3333343	3265823	51275	35892	8618	0.9845422112943302	0.9891292858408434	genomes
global_rank	syndip	VQSR	True	809	-1.0	-1.0	-1.0	28265	11159	8618	8488	3361608	3276982	59893	24733	0	0.9820511706312044	0.9925090445420032	genomes
truth_sample_rank	NA12878	RF	False	810	0.0	0.9617872044416576	0.9617872044416576	2539	2533	5	1	2539	2533	5	245254	6208	0.9980299448384555	0.010222489476849068	genomes
truth_sample_rank	NA12878	RF	False	814	1.0	0.9617872044416576	0.9617872044416576	2540	2530	10	0	5079	5063	15	242724	6198	0.9970460811343048	0.02043287178100546	genomes
truth_sample_rank	NA12878	RF	False	818	2.0	0.9617872044416576	0.9617872044416576	2540	2533	7	0	7619	7596	22	240191	6191	0.9971121029141506	0.03065536125785453	genomes
truth_sample_rank	NA12878	RF	False	822	3.0	0.9617872044416576	0.9617872044416576	2540	2527	13	0	10159	10123	35	237664	6178	0.9965544398503643	0.04085363638931824	genomes
truth_sample_rank	NA12878	RF	False	826	4.0	0.9617872044416576	0.9617872044416576	2540	2532	8	0	12699	12655	43	235132	6170	0.9966136399432981	0.05107209014193642	genomes
truth_sample_rank	NA12878	RF	False	830	5.0	0.9617872044416576	0.9617872044416576	2540	2532	8	0	15239	15187	51	232600	6162	0.9966531040819006	0.0612905438945546	genomes
truth_sample_rank	NA12878	RF	False	834	6.0	0.9617872044416576	0.9617872044416576	2540	2534	5	1	17779	17721	56	230066	6157	0.9968498621814704	0.07151706909563456	genomes
truth_sample_rank	NA12878	RF	False	838	7.0	0.9617872044416576	0.9617872044416576	2540	2534	6	0	20319	20255	62	227532	6151	0.9969483683614707	0.08174359429671452	genomes
truth_sample_rank	NA12878	RF	False	842	8.0	0.9617872044416576	0.9617872044416576	2540	2538	2	0	22859	22793	64	224994	6149	0.9971999824998906	0.09198626239471805	genomes
truth_sample_rank	NA12878	RF	False	846	9.0	0.9617872044416576	0.9617872044416576	2540	2533	7	0	25399	25326	71	222461	6142	0.9972043942197898	0.10220875187156711	genomes
truth_sample_rank	NA12878	RF	False	850	10.0	0.9617872044416576	0.9617872044416576	2540	2530	10	0	27939	27856	81	219931	6132	0.9971006192504563	0.11241913417572351	genomes
truth_sample_rank	NA12878	RF	False	854	11.0	0.9617872044416576	0.9617872044416576	2540	2533	6	1	30479	30389	87	217398	6126	0.9971452946580917	0.12264162365257257	genomes
truth_sample_rank	NA12878	RF	False	858	12.0	0.9614095443591661	0.9617872044416576	2540	2533	5	2	33019	32922	92	214865	6121	0.9972133034470225	0.13286411312942165	genomes
truth_sample_rank	NA12878	RF	False	862	13.0	0.9614095443591661	0.9614095443591661	2540	2525	15	0	35559	35447	107	212340	6106	0.9969904933340834	0.14305431681242356	genomes
truth_sample_rank	NA12878	RF	False	866	14.0	0.9614095443591661	0.9614095443591661	2540	2523	17	0	38099	37970	124	209817	6089	0.9967448942090618	0.15323644904696374	genomes
truth_sample_rank	NA12878	RF	False	870	15.0	0.9614095443591661	0.9614095443591661	2540	2516	24	0	40639	40486	148	207301	6065	0.9963577299798199	0.16339033121188762	genomes
truth_sample_rank	NA12878	RF	False	874	16.0	0.9614095443591661	0.9614095443591661	2540	2525	15	0	43179	43011	163	204776	6050	0.9962245796080975	0.17358053489488956	genomes
truth_sample_rank	NA12878	RF	False	878	17.0	0.9614095443591661	0.9614095443591661	2540	2516	24	0	45719	45527	187	202260	6026	0.995909349433434	0.18373441705981347	genomes
truth_sample_rank	NA12878	RF	False	882	18.0	0.9614095443591661	0.9614095443591661	2540	2532	8	0	48259	48059	195	199728	6018	0.9959588842375762	0.19395287081243165	genomes
truth_sample_rank	NA12878	RF	False	886	19.0	0.9614095443591661	0.9614095443591661	2540	2528	12	0	50799	50587	207	197200	6006	0.9959247155175808	0.20415518166812624	genomes
truth_sample_rank	NA12878	RF	False	890	20.0	0.9614095443591661	0.9614095443591661	2540	2523	17	0	53339	53110	224	194677	5989	0.9958000524993438	0.21433731390266642	genomes
truth_sample_rank	NA12878	RF	False	894	21.0	0.9614095443591661	0.9614095443591661	2540	2519	21	0	55879	55629	245	192158	5968	0.9956151340516162	0.22450330324028298	genomes
truth_sample_rank	NA12878	RF	False	898	22.0	0.9614095443591661	0.9614095443591661	2540	2529	11	0	58419	58158	256	189629	5957	0.9956174889581265	0.23470964982020848	genomes
truth_sample_rank	NA12878	RF	False	902	23.0	0.9614095443591661	0.9614095443591661	2540	2522	18	0	60959	60680	274	187107	5939	0.9955048069035666	0.24488774633051774	genomes
truth_sample_rank	NA12878	RF	False	906	24.0	0.9614095443591661	0.9614095443591661	2540	2527	13	0	63499	63207	287	184580	5926	0.9954798878634201	0.25508602146198145	genomes
truth_sample_rank	NA12878	RF	False	910	25.0	0.9614095443591661	0.9614095443591661	2540	2528	12	0	66039	65735	299	182052	5914	0.9954720295605294	0.26528833231767607	genomes
truth_sample_rank	NA12878	RF	False	914	26.0	0.9614095443591661	0.9614095443591661	2540	2518	22	0	68579	68253	321	179534	5892	0.9953189255402922	0.27545028593106174	genomes
truth_sample_rank	NA12878	RF	False	918	27.0	0.9614095443591661	0.9614095443591661	2540	2527	13	0	71119	70780	334	177007	5879	0.9953033158027955	0.28564856106252545	genomes
truth_sample_rank	NA12878	RF	False	922	28.0	0.9614095443591661	0.9614095443591661	2540	2531	9	0	73659	73311	343	174476	5870	0.9953430906671735	0.29586297909091275	genomes
truth_sample_rank	NA12878	RF	False	926	29.0	0.9611559254035803	0.9614095443591661	2540	2521	16	3	76199	75832	359	171955	5854	0.995288157393918	0.3060370398769911	genomes
truth_sample_rank	NA12878	RF	False	930	30.0	0.9610382745299405	0.9611559254035803	2540	2524	15	1	78739	78356	374	169431	5839	0.9952495871967484	0.3162232078357622	genomes
truth_sample_rank	NA12878	RF	False	934	31.0	0.9610382745299405	0.9610382745299405	2540	2531	9	0	81279	80887	383	166900	5830	0.995287313891965	0.3264376258641494	genomes
truth_sample_rank	NA12878	RF	False	938	32.0	0.9610382745299405	0.9610382745299405	2540	2530	10	0	83819	83417	393	164370	5820	0.9953108220976017	0.33664800816830587	genomes
truth_sample_rank	NA12878	RF	False	942	33.0	0.9610382745299405	0.9610382745299405	2540	2531	9	0	86359	85948	402	161839	5811	0.9953445280833816	0.3468624261966931	genomes
truth_sample_rank	NA12878	RF	False	946	34.0	0.9608787431439086	0.9610382745299405	2540	2497	43	0	88899	88445	445	159342	5768	0.9949938125773428	0.3569396296012301	genomes
truth_sample_rank	NA12878	RF	False	950	35.0	0.9608501250586391	0.9608787431439086	2540	2517	23	0	91439	90962	468	156825	5745	0.9948813299792191	0.36709754749038487	genomes
truth_sample_rank	NA12878	RF	False	954	36.0	0.9607260839317334	0.9608501250586391	2540	2521	18	1	93979	93483	486	154304	5727	0.9948280816013791	0.3772716082764633	genomes
truth_sample_rank	NA12878	RF	False	958	37.0	0.9606606144474491	0.9607260839317334	2540	2510	30	0	96519	95993	516	151794	5697	0.994653348392378	0.38740127609600183	genomes
truth_sample_rank	NA12878	RF	False	962	38.0	0.9606606144474491	0.9606606144474491	2540	2522	18	0	99059	98515	534	149272	5679	0.9946087290129128	0.39757937260631104	genomes
truth_sample_rank	NA12878	RF	False	966	39.0	0.9606251241883228	0.9606606144474491	2540	2525	15	0	101599	101040	549	146747	5664	0.9945958716002716	0.407769576289313	genomes
truth_sample_rank	NA12878	RF	False	970	40.0	0.9603744618862137	0.9606251241883228	2540	2523	17	0	104139	103563	566	144224	5647	0.994564434499515	0.41795170852385316	genomes
truth_sample_rank	NA12878	RF	False	974	41.0	0.9595380127280835	0.9603744618862137	2540	2509	30	1	106679	106072	596	141715	5617	0.994412569842877	0.4280773406191608	genomes
truth_sample_rank	NA12878	RF	False	978	42.0	0.9578061650275391	0.9595380127280835	2540	2522	16	2	109219	108594	612	139193	5601	0.9943959123125103	0.43825543712947007	genomes
truth_sample_rank	NA12878	RF	False	982	43.0	0.9578061650275391	0.9578061650275391	2540	2534	6	0	111759	111128	618	136659	5595	0.9944696007015911	0.44848196233055004	genomes
truth_sample_rank	NA12878	RF	False	986	44.0	0.9574285049450477	0.9578061650275391	2540	2525	15	0	114299	113653	633	134134	5580	0.9944612638468404	0.458672166013552	genomes
truth_sample_rank	NA12878	RF	False	990	45.0	0.9556878258854986	0.9574285049450477	2540	2513	25	2	116839	116166	658	131621	5555	0.9943675956995138	0.4688139410057832	genomes
truth_sample_rank	NA12878	RF	False	994	46.0	0.9510225421862873	0.9556224427982494	2540	2467	71	2	119379	118633	729	129154	5484	0.9938925286104455	0.4787700726833934	genomes
truth_sample_rank	NA12878	RF	False	998	47.0	0.945821890629274	0.9510225421862873	2540	2514	26	0	121919	121147	755	126640	5458	0.9938065003035225	0.48891588339985553	genomes
truth_sample_rank	NA12878	RF	False	1002	48.0	0.945821890629274	0.945821890629274	2540	2516	24	0	124459	123663	779	124124	5434	0.9937400556082352	0.49906976556477944	genomes
truth_sample_rank	NA12878	RF	False	1006	49.0	0.9454506208000484	0.945821890629274	2540	2523	17	0	126999	126186	796	121601	5417	0.9937313950008663	0.5092518977993196	genomes
truth_sample_rank	NA12878	RF	False	1010	50.0	0.9442918624714448	0.9454506208000484	2540	2502	37	1	129539	128688	833	119099	5380	0.9935686104955953	0.519349279825011	genomes
truth_sample_rank	NA12878	RF	False	1014	51.0	0.9424904913089737	0.9442918624714448	2540	2478	61	1	132079	131166	894	116621	5319	0.9932303498409814	0.529349804469161	genomes
truth_sample_rank	NA12878	RF	False	1018	52.0	0.9325909236048364	0.9424901356313247	2541	2490	47	4	134620	133656	941	114131	5272	0.9930087594820093	0.5393987578040818	genomes
truth_sample_rank	NA12878	RF	False	1022	53.0	0.9325909236048364	0.9325909236048364	2539	2528	10	1	137159	136184	951	111603	5262	0.9930652276953367	0.5496010686597763	genomes
truth_sample_rank	NA12878	RF	False	1026	54.0	0.932213263522345	0.9325909236048364	2540	2500	37	3	139699	138684	988	109103	5225	0.9929262844378257	0.5596903792370059	genomes
truth_sample_rank	NA12878	RF	False	1030	55.0	0.932213263522345	0.932213263522345	2540	2501	39	0	142239	141185	1027	106602	5186	0.9927783871965797	0.5697837255384665	genomes
truth_sample_rank	NA12878	RF	False	1034	56.0	0.9317105320565465	0.932213263522345	2540	2520	17	3	144779	143705	1044	104082	5169	0.9927875149396541	0.579953750600314	genomes
truth_sample_rank	NA12878	RF	False	1038	57.0	0.9313328719740551	0.9317105320565465	2540	2497	39	4	147319	146202	1083	101585	5130	0.9926469090538751	0.590030954004851	genomes
truth_sample_rank	NA12878	RF	False	1042	58.0	0.9308852966224733	0.9313328719740551	2541	2514	27	0	149860	148716	1110	99071	5103	0.9925914060309959	0.6001767647213131	genomes
truth_sample_rank	NA12878	RF	False	1046	59.0	0.9302727524052729	0.9308852966224733	2539	2517	17	5	152399	151233	1127	96554	5086	0.9926030454187451	0.6103346826104679	genomes
truth_sample_rank	NA12878	RF	False	1050	60.0	0.9298950923227814	0.9302727524052729	2540	2518	22	0	154939	153751	1149	94036	5064	0.9925823111684958	0.6204966362238535	genomes
truth_sample_rank	NA12878	RF	False	1054	61.0	0.9295194070642406	0.9298950923227814	2540	2507	31	2	157479	156258	1180	91529	5033	0.9925049860897623	0.6306141968706994	genomes
truth_sample_rank	NA12878	RF	False	1058	62.0	0.929392360856983	0.9295194070642406	2540	2523	15	2	160019	158781	1195	89006	5018	0.9925301295194279	0.6407963291052395	genomes
truth_sample_rank	NA12878	RF	False	1062	63.0	0.9291417469817493	0.929392360856983	2540	2512	26	2	162559	161293	1221	86494	4992	0.9924868011371328	0.65093406837324	genomes
truth_sample_rank	NA12878	RF	False	1066	64.0	0.9290147007744916	0.9291417469817493	2540	2508	31	1	165099	163801	1252	83986	4961	0.9924145577481173	0.6610556647443167	genomes
truth_sample_rank	NA12878	RF	False	1070	65.0	0.9285671254229099	0.9290147007744916	2540	2496	43	1	167639	166297	1295	81490	4918	0.9922729008544561	0.6711288324246227	genomes
truth_sample_rank	NA12878	RF	False	1074	66.0	0.9281267010374931	0.9285671254229099	2540	2505	34	1	170179	168802	1329	78985	4884	0.9921883724894346	0.6812383216230069	genomes
truth_sample_rank	NA12878	RF	False	1078	67.0	0.9278137800818776	0.9281267010374931	2540	2505	35	0	172719	171307	1364	76480	4849	0.9921005843482692	0.691347810821391	genomes
truth_sample_rank	NA12878	RF	False	1082	68.0	0.9272012358646772	0.9278137800818776	2540	2489	51	0	175259	173796	1415	73991	4798	0.9919240230350834	0.7013927284320808	genomes
truth_sample_rank	NA12878	RF	False	1086	69.0	0.9268235757821858	0.9272012358646772	2540	2519	21	0	177799	176315	1436	71472	4777	0.9919212831432734	0.7115587177696974	genomes
truth_sample_rank	NA12878	RF	False	1090	70.0	0.9261926033687898	0.9268235757821858	2540	2502	36	2	180339	178817	1472	68970	4741	0.9918353310518112	0.7216560997953888	genomes
truth_sample_rank	NA12878	RF	False	1094	71.0	0.9249916596496058	0.9261926033687898	2540	2494	44	2	182879	181311	1516	66476	4697	0.991708008116963	0.7317211960272331	genomes
truth_sample_rank	NA12878	RF	False	1098	72.0	0.9217495964288182	0.9249916596496058	2540	2477	55	8	185419	183788	1571	63999	4642	0.9915245550526276	0.7417176849471522	genomes
truth_sample_rank	NA12878	RF	False	1102	73.0	0.9203194071936307	0.9217053856796462	2540	2505	33	2	187959	186293	1604	61494	4609	0.9914634081438235	0.7518271741455362	genomes
truth_sample_rank	NA12878	RF	False	1106	74.0	0.9198509319183881	0.9203194071936307	2540	2509	27	4	190499	188802	1631	58985	4582	0.991435307956079	0.7619528062408439	genomes
truth_sample_rank	NA12878	RF	False	1110	75.0	0.9193691003762504	0.9198509319183881	2540	2525	14	1	193039	191327	1645	56460	4568	0.99147544721514	0.7721430099238459	genomes
truth_sample_rank	NA12878	RF	False	1114	76.0	0.9182697243613184	0.9193691003762504	2540	2507	32	1	195579	193834	1677	53953	4536	0.9914224775076594	0.7822605705706918	genomes
truth_sample_rank	NA12878	RF	False	1118	77.0	0.9166604170649097	0.9182697243613184	2540	2500	39	1	198119	196334	1716	51453	4497	0.9913355213329967	0.7923498811479214	genomes
truth_sample_rank	NA12878	RF	False	1122	78.0	0.9155610410499777	0.9166604170649097	2540	2517	23	0	200659	198851	1739	48936	4474	0.9913305748043272	0.8025077990370763	genomes
truth_sample_rank	NA12878	RF	False	1126	79.0	0.9116565624092954	0.9155610410499777	2540	2483	52	5	203199	201334	1791	46453	4422	0.9911827692307692	0.8125285023023807	genomes
truth_sample_rank	NA12878	RF	False	1130	80.0	0.9093335569998968	0.9116565624092954	2540	2492	44	4	205739	203826	1835	43961	4378	0.991077549948702	0.8225855270857632	genomes
truth_sample_rank	NA12878	RF	False	1134	81.0	0.9060156033965358	0.9093335569998968	2540	2469	69	2	208279	206295	1904	41492	4309	0.9908549032416102	0.8325497302118352	genomes
truth_sample_rank	NA12878	RF	False	1138	82.0	0.8967602478397856	0.9059995969836366	2540	2461	76	3	210819	208756	1980	39031	4233	0.9906043580593729	0.84248164754406	genomes
truth_sample_rank	NA12878	RF	False	1142	83.0	0.8817148510733903	0.8967470769269857	2540	2445	88	7	213359	211201	2068	36586	4145	0.9903033258467007	0.8523489932885906	genomes
truth_sample_rank	NA12878	RF	False	1146	84.0	0.85992335584262	0.8817148510733903	2540	2454	78	8	215899	213655	2146	34132	4067	0.9900556531248697	0.8622526605511992	genomes
truth_sample_rank	NA12878	RF	False	1150	85.0	0.8453832114726403	0.8598672546090169	2540	2475	61	4	218439	216130	2207	31657	4006	0.9898917728099222	0.8722410780226566	genomes
truth_sample_rank	NA12878	RF	False	1154	86.0	0.8426403398787013	0.8453832114726403	2540	2482	54	4	220979	218612	2261	29175	3952	0.9897633481684045	0.8822577455637302	genomes
truth_sample_rank	NA12878	RF	False	1158	87.0	0.8331701602013839	0.8426054013590969	2540	2432	98	10	223519	221044	2359	26743	3854	0.9894406073329365	0.8920726268932592	genomes
truth_sample_rank	NA12878	RF	False	1162	88.0	0.8225912891458591	0.8331701602013839	2540	2426	96	18	226059	223470	2455	24317	3758	0.9891335620227951	0.9018632938774027	genomes
truth_sample_rank	NA12878	RF	False	1166	89.0	0.8140727370829066	0.8225689906576117	2540	2472	64	4	228599	225942	2519	21845	3694	0.988974048086982	0.9118396041761674	genomes
truth_sample_rank	NA12878	RF	False	1170	90.0	0.7926221935473898	0.8140727370829066	2540	2416	110	14	231139	228358	2629	19429	3584	0.9886184070965033	0.9215899139180022	genomes
truth_sample_rank	NA12878	RF	False	1174	91.0	0.7755681214158455	0.7925945325723668	2540	2435	102	3	233679	230793	2731	16994	3482	0.9883052705503503	0.9314169024202238	genomes
truth_sample_rank	NA12878	RF	False	1178	92.0	0.7545145554176678	0.7755609877289056	2540	2403	126	11	236219	233196	2857	14591	3356	0.987896785891304	0.941114747747057	genomes
truth_sample_rank	NA12878	RF	False	1182	93.0	0.7382366943809232	0.754494551461272	2540	2458	74	8	238759	235654	2931	12133	3282	0.9877150701008026	0.9510345579065891	genomes
truth_sample_rank	NA12878	RF	False	1186	94.0	0.7020937103988952	0.7382184164387964	2540	2418	110	12	241299	238072	3041	9715	3172	0.987387656410065	0.9607929390968857	genomes
truth_sample_rank	NA12878	RF	False	1190	95.0	0.6204905515645026	0.7020937103988952	2540	2372	144	24	243839	240444	3185	7343	3028	0.9869268436844546	0.9703656769725612	genomes
truth_sample_rank	NA12878	RF	False	1194	96.0	0.5924388455820971	0.6204905515645026	2540	2327	196	17	246379	242771	3381	5016	2832	0.9862645844843836	0.9797568072578464	genomes
truth_sample_rank	NA12878	RF	False	1198	97.0	0.07547163191646149	0.5924388455820971	2540	1786	677	77	248919	244557	4058	3230	2155	0.9836775737586227	0.9869646107342193	genomes
truth_sample_rank	NA12878	RF	False	1202	98.0	0.0014916482210623925	0.07535702913766064	2540	36	2155	349	251459	244593	6213	3194	0	0.9752278653620727	0.9871098968065314	genomes
truth_sample_rank	NA12878	RF	False	1206	99.0	-1.0	-1.0	2540	0	0	2540	253999	244593	6213	3194	0	0.9752278653620727	0.9871098968065314	genomes
truth_sample_rank	NA12878	RF	False	1210	100.0	-1.0	-1.0	1	0	0	1	254000	244593	6213	3194	0	0.9752278653620727	0.9871098968065314	genomes
truth_sample_rank	NA12878	RF	True	1214	0.0	0.9719609898644941	0.9719609898644941	31450	31446	2	2	31450	31446	2	3083379	30202	0.999936402950903	0.010095591245094026	genomes
truth_sample_rank	NA12878	RF	True	1218	1.0	0.9719609898644941	0.9719609898644941	31450	31445	4	1	62900	62891	6	3051934	30198	0.9999046059430498	0.02019086144486448	genomes
truth_sample_rank	NA12878	RF	True	1222	2.0	0.9719609898644941	0.9719609898644941	31450	31445	5	0	94350	94336	11	3020489	30193	0.999883409117407	0.03028613164463493	genomes
truth_sample_rank	NA12878	RF	True	1226	3.0	0.9719609898644941	0.9719609898644941	31451	31449	1	1	125801	125785	12	2989040	30192	0.999904608218002	0.04038268602569968	genomes
truth_sample_rank	NA12878	RF	True	1230	4.0	0.9719609898644941	0.9719609898644941	31450	31445	2	3	157251	157230	14	2957595	30190	0.999910966396174	0.05047795622547013	genomes
truth_sample_rank	NA12878	RF	True	1234	5.0	0.9719609898644941	0.9719609898644941	31450	31446	3	1	188701	188676	17	2926149	30187	0.9999099065678112	0.060573547470564156	genomes
truth_sample_rank	NA12878	RF	True	1238	6.0	0.9719609898644941	0.9719609898644941	31451	31446	5	0	220152	220122	22	2894703	30182	0.9999000654117305	0.07066913871565818	genomes
truth_sample_rank	NA12878	RF	True	1242	7.0	0.9719609898644941	0.9719609898644941	31450	31446	3	1	251602	251568	25	2863257	30179	0.9999006331654696	0.08076472996075221	genomes
truth_sample_rank	NA12878	RF	True	1246	8.0	0.9719609898644941	0.9719609898644941	31450	31443	4	3	283052	283011	29	2831814	30175	0.9998975409836065	0.09085935806987551	genomes
truth_sample_rank	NA12878	RF	True	1250	9.0	0.9719609898644941	0.9719609898644941	31450	31444	4	2	314502	314455	33	2800370	30171	0.999895067538348	0.10095430722432239	genomes
truth_sample_rank	NA12878	RF	True	1254	10.0	0.9719609898644941	0.9719609898644941	31451	31450	1	0	345953	345905	34	2768920	30170	0.9999017167766572	0.11105118265071072	genomes
truth_sample_rank	NA12878	RF	True	1258	11.0	0.9719609898644941	0.9719609898644941	31450	31445	5	0	377403	377350	39	2737475	30165	0.9998966583551719	0.12114645285048117	genomes
truth_sample_rank	NA12878	RF	True	1262	12.0	0.9719609898644941	0.9719609898644941	31450	31447	3	0	408853	408797	42	2706028	30162	0.9998972700745281	0.13124236514089876	genomes
truth_sample_rank	NA12878	RF	True	1266	13.0	0.9719609898644941	0.9719609898644941	31451	31444	4	3	440304	440241	46	2674584	30158	0.9998955226931524	0.14133731429534566	genomes
truth_sample_rank	NA12878	RF	True	1270	14.0	0.9719609898644941	0.9719609898644941	31450	31449	1	0	471754	471690	47	2643135	30157	0.9999003682136445	0.1514338686764104	genomes
truth_sample_rank	NA12878	RF	True	1274	15.0	0.9719609898644941	0.9719609898644941	31450	31444	4	2	503204	503134	51	2611691	30153	0.9998986456273538	0.16152881783085726	genomes
truth_sample_rank	NA12878	RF	True	1278	16.0	0.9719609898644941	0.9719609898644941	31450	31443	5	2	534654	534577	56	2580248	30148	0.999895255249863	0.17162344593998058	genomes
truth_sample_rank	NA12878	RF	True	1282	17.0	0.9719609898644941	0.9719609898644941	31451	31448	2	1	566105	566025	58	2548800	30146	0.9998975415265959	0.18171967927572175	genomes
truth_sample_rank	NA12878	RF	True	1286	18.0	0.9719609898644941	0.9719609898644941	31450	31443	6	1	597555	597468	64	2517357	30140	0.9998928927655757	0.19181430738484506	genomes
truth_sample_rank	NA12878	RF	True	1290	19.0	0.9719609898644941	0.9719609898644941	31450	31446	4	0	629005	628914	68	2485911	30136	0.9998918887980897	0.20190989862993908	genomes
truth_sample_rank	NA12878	RF	True	1294	20.0	0.9719609898644941	0.9719609898644941	31451	31448	2	1	660456	660362	70	2454463	30134	0.9998940087700172	0.21200613196568024	genomes
truth_sample_rank	NA12878	RF	True	1298	21.0	0.9719609898644941	0.9719609898644941	31450	31447	2	1	691906	691809	72	2423016	30132	0.9998959358618028	0.22210204425609786	genomes
truth_sample_rank	NA12878	RF	True	1302	22.0	0.9719609898644941	0.9719609898644941	31450	31449	0	1	723356	723258	72	2391567	30132	0.9999004603707852	0.2321985986371626	genomes
truth_sample_rank	NA12878	RF	True	1306	23.0	0.9719609898644941	0.9719609898644941	31450	31443	6	1	754806	754701	78	2360124	30126	0.9998966584920884	0.2422932267462859	genomes
truth_sample_rank	NA12878	RF	True	1310	24.0	0.9719609898644941	0.9719609898644941	31451	31448	3	0	786257	786149	81	2328676	30123	0.9998969767116492	0.25238946008202706	genomes
truth_sample_rank	NA12878	RF	True	1314	25.0	0.9719609898644941	0.9719609898644941	31450	31444	6	0	817707	817593	87	2297232	30117	0.9998936014088641	0.262484409236474	genomes
truth_sample_rank	NA12878	RF	True	1318	26.0	0.9719609898644941	0.9719609898644941	31450	31443	7	0	849157	849036	94	2265789	30110	0.9998892984584221	0.27257903734559724	genomes
truth_sample_rank	NA12878	RF	True	1322	27.0	0.9719609898644941	0.9719609898644941	31451	31449	1	1	880608	880485	95	2234340	30109	0.9998921165595404	0.282675591726662	genomes
truth_sample_rank	NA12878	RF	True	1326	28.0	0.9719609898644941	0.9719609898644941	31450	31443	6	1	912058	911928	101	2202897	30103	0.9998892579073692	0.29277021983578533	genomes
truth_sample_rank	NA12878	RF	True	1330	29.0	0.9719609898644941	0.9719609898644941	31450	31442	4	4	943508	943370	105	2171455	30099	0.9998887092927741	0.30286452689958504	genomes
truth_sample_rank	NA12878	RF	True	1334	30.0	0.9719609898644941	0.9719609898644941	31450	31448	2	0	974958	974818	107	2140007	30097	0.9998902479677924	0.3129607602353262	genomes
truth_sample_rank	NA12878	RF	True	1338	31.0	0.9719609898644941	0.9719609898644941	31451	31450	1	0	1006409	1006268	108	2108557	30096	0.9998926842452522	0.3230576356617145	genomes
truth_sample_rank	NA12878	RF	True	1342	32.0	0.9719609898644941	0.9719609898644941	31450	31444	4	2	1037859	1037712	112	2077113	30092	0.9998920818944252	0.33315258481616145	genomes
truth_sample_rank	NA12878	RF	True	1346	33.0	0.9719609898644941	0.9719609898644941	31450	31447	1	2	1069309	1069159	113	2045666	30091	0.9998943206218811	0.343248497106579	genomes
truth_sample_rank	NA12878	RF	True	1350	34.0	0.9719609898644941	0.9719609898644941	31451	31446	5	0	1100760	1100605	118	2014220	30086	0.9998927977338531	0.353344088351673	genomes
truth_sample_rank	NA12878	RF	True	1354	35.0	0.9719609898644941	0.9719609898644941	31450	31444	6	0	1132210	1132049	124	1982776	30080	0.9998904761021504	0.36343903750611994	genomes
truth_sample_rank	NA12878	RF	True	1358	36.0	0.9719609898644941	0.9719609898644941	31450	31444	6	0	1163660	1163493	130	1951332	30074	0.9998882799669653	0.3735339866605668	genomes
truth_sample_rank	NA12878	RF	True	1362	37.0	0.9719609898644941	0.9719609898644941	31450	31444	5	1	1195110	1194937	135	1919888	30069	0.9998870360948964	0.38362893581501367	genomes
truth_sample_rank	NA12878	RF	True	1366	38.0	0.9719609898644941	0.9719609898644941	31451	31443	8	0	1226561	1226380	143	1888445	30061	0.9998834102581036	0.393723563924137	genomes
truth_sample_rank	NA12878	RF	True	1370	39.0	0.9719609898644941	0.9719609898644941	31450	31446	4	0	1258011	1257826	147	1856999	30057	0.9998831453457269	0.403819155169231	genomes
truth_sample_rank	NA12878	RF	True	1374	40.0	0.9719609898644941	0.9719609898644941	31450	31449	1	0	1289461	1289275	148	1825550	30056	0.9998852199782383	0.4139157095502958	genomes
truth_sample_rank	NA12878	RF	True	1378	41.0	0.9719609898644941	0.9719609898644941	31451	31444	5	2	1320912	1320719	153	1794106	30051	0.9998841674287895	0.42401065870474264	genomes
truth_sample_rank	NA12878	RF	True	1382	42.0	0.9719609898644941	0.9719609898644941	31450	31448	2	0	1352362	1352167	155	1762658	30049	0.9998853823275817	0.4341068920404838	genomes
truth_sample_rank	NA12878	RF	True	1386	43.0	0.9719609898644941	0.9719609898644941	31450	31445	5	0	1383812	1383612	160	1731213	30044	0.9998843740153724	0.4442021622402543	genomes
truth_sample_rank	NA12878	RF	True	1390	44.0	0.9719609898644941	0.9719609898644941	31450	31384	11	55	1415262	1414996	171	1699829	30033	0.9998791662044126	0.45427784867528676	genomes
truth_sample_rank	NA12878	RF	True	1394	45.0	0.9719609898644941	0.9719609898644941	31451	31449	2	0	1446713	1446445	173	1668380	30031	0.9998804107234944	0.46437440305635147	genomes
truth_sample_rank	NA12878	RF	True	1398	46.0	0.9719609898644941	0.9719609898644941	31450	31446	4	0	1478163	1477891	177	1636934	30027	0.9998802490819096	0.4744699943014455	genomes
truth_sample_rank	NA12878	RF	True	1402	47.0	0.9719609898644941	0.9719609898644941	31450	31443	6	1	1509613	1509334	183	1605491	30021	0.999878769169211	0.4845646224105688	genomes
truth_sample_rank	NA12878	RF	True	1406	48.0	0.9719609898644941	0.9719609898644941	31451	31445	4	2	1541064	1540779	187	1574046	30017	0.9998786475496539	0.49465989261033927	genomes
truth_sample_rank	NA12878	RF	True	1410	49.0	0.9719609898644941	0.9719609898644941	31450	31445	1	4	1572514	1572224	188	1542601	30016	0.9998804384601491	0.5047551628101097	genomes
truth_sample_rank	NA12878	RF	True	1414	50.0	0.9719609898644941	0.9719609898644941	31450	31445	4	1	1603964	1603669	192	1511156	30012	0.9998802888779015	0.5148504330098802	genomes
truth_sample_rank	NA12878	RF	True	1418	51.0	0.9719609898644941	0.9719609898644941	31450	31445	2	3	1635414	1635114	194	1479711	30010	0.9998813679135673	0.5249457032096506	genomes
truth_sample_rank	NA12878	RF	True	1422	52.0	0.9719609898644941	0.9719609898644941	31451	31448	3	0	1666865	1666562	197	1448263	30007	0.9998818065479173	0.5350419365453918	genomes
truth_sample_rank	NA12878	RF	True	1426	53.0	0.9715833297820027	0.9719609898644941	31450	31425	6	19	1698315	1697987	203	1416838	30001	0.9998804609613765	0.5451307858386908	genomes
truth_sample_rank	NA12878	RF	True	1430	54.0	0.9715833297820027	0.9715833297820027	31450	31433	17	0	1729765	1729420	220	1385405	29984	0.9998728059018062	0.5552222034945783	genomes
truth_sample_rank	NA12878	RF	True	1434	55.0	0.9715833297820027	0.9715833297820027	31451	31439	11	1	1761216	1760859	231	1353966	29973	0.9998688312352009	0.5653155474224073	genomes
truth_sample_rank	NA12878	RF	True	1438	56.0	0.9715833297820027	0.9715833297820027	31450	31442	8	0	1792666	1792301	239	1322524	29965	0.9998666696419606	0.5754098544862071	genomes
truth_sample_rank	NA12878	RF	True	1442	57.0	0.9715833297820027	0.9715833297820027	31450	31433	17	0	1824116	1823734	256	1291091	29948	0.9998596483533353	0.5855012721420947	genomes
truth_sample_rank	NA12878	RF	True	1446	58.0	0.9715833297820027	0.9715833297820027	31451	31440	11	0	1855567	1855174	267	1259651	29937	0.999856098900477	0.5955949371152472	genomes
truth_sample_rank	NA12878	RF	True	1450	59.0	0.9715833297820027	0.9715833297820027	31450	31435	15	0	1887017	1886609	282	1228216	29922	0.9998505478058881	0.605686996861782	genomes
truth_sample_rank	NA12878	RF	True	1454	60.0	0.9715833297820027	0.9715833297820027	31450	31445	5	0	1918467	1918054	287	1196771	29917	0.9998503915622926	0.6157822670615524	genomes
truth_sample_rank	NA12878	RF	True	1458	61.0	0.9715833297820027	0.9715833297820027	31450	31438	11	1	1949917	1949492	298	1165333	29906	0.9998471630278133	0.6258752899440578	genomes
truth_sample_rank	NA12878	RF	True	1462	62.0	0.9715833297820027	0.9715833297820027	31451	31437	14	0	1981368	1980929	312	1133896	29892	0.9998425229439528	0.6359679917812397	genomes
truth_sample_rank	NA12878	RF	True	1466	63.0	0.9715833297820027	0.9715833297820027	31450	31433	16	1	2012818	2012362	328	1102463	29876	0.9998370340191485	0.6460594094371273	genomes
truth_sample_rank	NA12878	RF	True	1470	64.0	0.9715833297820027	0.9715833297820027	31450	31438	12	0	2044268	2043800	340	1071025	29864	0.999833670883599	0.6561524323196327	genomes
truth_sample_rank	NA12878	RF	True	1474	65.0	0.9715833297820027	0.9715833297820027	31450	31433	12	5	2075718	2075233	352	1039592	29852	0.9998304092581127	0.6662438499755203	genomes
truth_sample_rank	NA12878	RF	True	1478	66.0	0.9715833297820027	0.9715833297820027	31451	31438	13	0	2107169	2106671	365	1008154	29839	0.9998267708762452	0.6763368728580257	genomes
truth_sample_rank	NA12878	RF	True	1482	67.0	0.9715833297820027	0.9715833297820027	31450	31440	10	0	2138619	2138111	375	976714	29829	0.9998246422936601	0.6864305378311784	genomes
truth_sample_rank	NA12878	RF	True	1486	68.0	0.9715833297820027	0.9715833297820027	31450	31440	10	0	2170069	2169551	385	945274	29819	0.9998225754123624	0.6965242028043309	genomes
truth_sample_rank	NA12878	RF	True	1490	69.0	0.9715833297820027	0.9715833297820027	31451	31434	15	2	2201520	2200985	400	913840	29804	0.9998182962089776	0.7066159415055421	genomes
truth_sample_rank	NA12878	RF	True	1494	70.0	0.9715833297820027	0.9715833297820027	31450	31436	14	0	2232970	2232421	414	882404	29790	0.9998145854933302	0.7167083222974003	genomes
truth_sample_rank	NA12878	RF	True	1498	71.0	0.9715833297820027	0.9715833297820027	31450	31438	11	1	2264420	2263859	425	850966	29779	0.9998123026970115	0.7268013451799058	genomes
truth_sample_rank	NA12878	RF	True	1502	72.0	0.9715833297820027	0.9715833297820027	31451	31437	11	3	2295871	2295296	436	819529	29768	0.99981008236153	0.7368940470170876	genomes
truth_sample_rank	NA12878	RF	True	1506	73.0	0.9715833297820027	0.9715833297820027	31450	31441	8	1	2327321	2326737	444	788088	29760	0.9998092112302395	0.7469880330355638	genomes
truth_sample_rank	NA12878	RF	True	1510	74.0	0.9715833297820027	0.9715833297820027	31450	31441	7	2	2358771	2358178	451	756647	29753	0.9998087872234251	0.7570820190540399	genomes
truth_sample_rank	NA12878	RF	True	1514	75.0	0.971329710826417	0.9715833297820027	31450	31432	16	2	2390221	2389610	467	725215	29737	0.9998046088054904	0.767173115664604	genomes
truth_sample_rank	NA12878	RF	True	1518	76.0	0.9709104254706233	0.971329710826417	31451	31441	5	5	2421672	2421051	472	693774	29732	0.9998050813475652	0.7772671016830801	genomes
truth_sample_rank	NA12878	RF	True	1522	77.0	0.9709104254706233	0.9709104254706233	31450	31444	3	3	2453122	2452495	475	662330	29729	0.9998063571914863	0.787362050837527	genomes
truth_sample_rank	NA12878	RF	True	1526	78.0	0.9709104254706233	0.9709104254706233	31450	31447	3	0	2484572	2483942	478	630883	29726	0.9998076009692403	0.7974579631279446	genomes
truth_sample_rank	NA12878	RF	True	1530	79.0	0.9709104254706233	0.9709104254706233	31451	31439	8	4	2516023	2515381	486	599444	29718	0.9998068260365115	0.8075513070557736	genomes
truth_sample_rank	NA12878	RF	True	1534	80.0	0.9707170463107051	0.9709104254706233	31450	31437	6	7	2547473	2546818	492	568007	29712	0.9998068550745689	0.8176440088929554	genomes
truth_sample_rank	NA12878	RF	True	1538	81.0	0.9707170463107051	0.9707170463107051	31450	31438	10	2	2578923	2578256	502	536569	29702	0.9998053326446297	0.8277370317754609	genomes
truth_sample_rank	NA12878	RF	True	1542	82.0	0.9707170463107051	0.9707170463107051	31450	31436	9	5	2610373	2609692	511	505133	29693	0.9998042297859592	0.8378294125673192	genomes
truth_sample_rank	NA12878	RF	True	1546	83.0	0.9707170463107051	0.9707170463107051	31451	31440	10	1	2641824	2641132	521	473693	29683	0.9998027750048928	0.8479230775404718	genomes
truth_sample_rank	NA12878	RF	True	1550	84.0	0.9705327653881318	0.9707170463107051	31450	31430	11	9	2673274	2672562	532	442263	29672	0.9998009796887053	0.8580135320603887	genomes
truth_sample_rank	NA12878	RF	True	1554	85.0	0.9704634273551194	0.9705327653881318	31450	31431	18	1	2704724	2703993	550	410832	29654	0.9997966384708988	0.8681043076256291	genomes
truth_sample_rank	NA12878	RF	True	1558	86.0	0.9703393862282137	0.9704634273551194	31451	31422	27	2	2736175	2735415	577	379410	29627	0.99978910757049	0.8781921937829573	genomes
truth_sample_rank	NA12878	RF	True	1562	87.0	0.9696664819168342	0.9703393862282137	31450	31440	9	1	2767625	2766855	586	347970	29618	0.9997882520350028	0.8882858587561099	genomes
truth_sample_rank	NA12878	RF	True	1566	88.0	0.9666507171598319	0.9696664819168342	31450	31425	18	7	2799075	2798280	604	316545	29600	0.9997841997024528	0.8983747080494089	genomes
truth_sample_rank	NA12878	RF	True	1570	89.0	0.9654246682444556	0.9666507171598319	31450	31396	25	29	2830525	2829676	629	285149	29575	0.9997777624672959	0.9084542470283242	genomes
truth_sample_rank	NA12878	RF	True	1574	90.0	0.9619722322274938	0.9654246682444556	31451	31378	46	27	2861976	2861054	675	253771	29529	0.9997641286089634	0.9185280071914153	genomes
truth_sample_rank	NA12878	RF	True	1578	91.0	0.9430274301180078	0.9619722322274938	31450	31339	83	28	2893426	2892393	758	222432	29446	0.9997380019224714	0.9285892465868869	genomes
truth_sample_rank	NA12878	RF	True	1582	92.0	0.9312021621109234	0.9430274301180078	31450	31274	133	43	2924876	2923667	891	191158	29313	0.9996953385776586	0.9386296180363263	genomes
truth_sample_rank	NA12878	RF	True	1586	93.0	0.8603978487646646	0.9312021621109234	31451	31162	222	67	2956327	2954829	1113	159996	29091	0.9996234702845996	0.9486340324095254	genomes
truth_sample_rank	NA12878	RF	True	1590	94.0	0.8530309454875322	0.8603978487646646	31450	31356	42	52	2987777	2986185	1155	128640	29049	0.99961336841471	0.9587007295754978	genomes
truth_sample_rank	NA12878	RF	True	1594	95.0	0.8486071070630382	0.8530309454875322	31450	31367	39	44	3019227	3017552	1194	97273	29010	0.9996044715255937	0.9687709582400296	genomes
truth_sample_rank	NA12878	RF	True	1598	96.0	0.843350661766393	0.8486071070630382	31450	31318	88	44	3050677	3048870	1282	65955	28922	0.9995796930775909	0.9788254556837062	genomes
truth_sample_rank	NA12878	RF	True	1602	97.0	0.7250692523610265	0.843350661766393	31451	30877	297	277	3082128	3079747	1579	35078	28625	0.9994875582784815	0.9887383721396868	genomes
truth_sample_rank	NA12878	RF	True	1606	98.0	0.27989251702139645	0.7250607370123429	31450	27739	3279	432	3113578	3107486	4858	7339	25346	0.9984391185550183	0.9976438483702936	genomes
truth_sample_rank	NA12878	RF	True	1610	99.0	0.0014067156666908416	0.27983677370622645	31450	3842	25346	2262	3145028	3111328	30204	3497	0	0.990385582575635	0.9988773045034632	genomes
truth_sample_rank	NA12878	RF	True	1614	100.0	-1.0	-1.0	1	0	0	1	3145029	3111328	30204	3497	0	0.990385582575635	0.9988773045034632	genomes
truth_sample_rank	NA12878	VQSR	False	811	0.0	7.97	93.56	2539	2516	23	0	2539	2516	23	245271	6190	0.9909413154785348	0.010153882164923906	genomes
truth_sample_rank	NA12878	VQSR	False	815	1.0	7.9	7.97	2540	2531	9	0	5079	5047	32	242740	6181	0.9936995471549518	0.020368300193311192	genomes
truth_sample_rank	NA12878	VQSR	False	819	2.0	7.84	7.9	2540	2534	5	1	7619	7581	37	240206	6176	0.9951430821737989	0.03059482539439115	genomes
truth_sample_rank	NA12878	VQSR	False	823	3.0	7.8	7.84	2540	2534	6	0	10159	10115	43	237672	6170	0.9957668832447332	0.04082135059547111	genomes
truth_sample_rank	NA12878	VQSR	False	827	4.0	7.76	7.8	2540	2532	8	0	12699	12647	51	235140	6162	0.9959836194676327	0.05103980434808929	genomes
truth_sample_rank	NA12878	VQSR	False	831	5.0	7.73	7.76	2540	2532	8	0	15239	15179	59	232608	6154	0.99612810080063	0.06125825810070746	genomes
truth_sample_rank	NA12878	VQSR	False	835	6.0	7.69	7.73	2540	2534	6	0	17779	17713	65	230074	6148	0.9963437957025537	0.07148478330178742	genomes
truth_sample_rank	NA12878	VQSR	False	839	7.0	7.66	7.69	2540	2530	9	1	20319	20243	74	227544	6139	0.9963577299798199	0.08169516560594381	genomes
truth_sample_rank	NA12878	VQSR	False	843	8.0	7.64	7.66	2540	2532	8	0	22859	22775	82	225012	6131	0.9964124775779849	0.09191361935856199	genomes
truth_sample_rank	NA12878	VQSR	False	847	9.0	7.61	7.64	2540	2533	7	0	25399	25308	89	222479	6124	0.9964956490924125	0.10213610883541106	genomes
truth_sample_rank	NA12878	VQSR	False	851	10.0	7.58	7.61	2540	2533	7	0	27939	27841	96	219946	6117	0.9965636968894298	0.11235859831226012	genomes
truth_sample_rank	NA12878	VQSR	False	855	11.0	7.56	7.58	2540	2537	3	0	30479	30378	99	217409	6114	0.9967516487843292	0.12259723068603276	genomes
truth_sample_rank	NA12878	VQSR	False	859	12.0	7.54	7.56	2540	2532	8	0	33019	32910	107	214877	6106	0.996759245237302	0.13281568443865094	genomes
truth_sample_rank	NA12878	VQSR	False	863	13.0	7.51	7.54	2540	2532	8	0	35559	35442	115	212345	6098	0.9967657563911466	0.14303413819126912	genomes
truth_sample_rank	NA12878	VQSR	False	867	14.0	7.49	7.51	2540	2536	4	0	38099	37978	119	209809	6094	0.9968763944667559	0.15326873484081086	genomes
truth_sample_rank	NA12878	VQSR	False	871	15.0	7.47	7.49	2540	2531	9	0	40639	40509	128	207278	6085	0.9968501611831582	0.16348315286919815	genomes
truth_sample_rank	NA12878	VQSR	False	875	16.0	7.44	7.47	2540	2533	7	0	43179	43042	135	204745	6078	0.9968733353405749	0.1737056423460472	genomes
truth_sample_rank	NA12878	VQSR	False	879	17.0	7.42	7.44	2540	2532	8	0	45719	45574	143	202213	6070	0.9968720607213947	0.1839240960986654	genomes
truth_sample_rank	NA12878	VQSR	False	883	18.0	7.4	7.42	2540	2531	9	0	48259	48105	152	199682	6061	0.9968501978987504	0.19413851412705266	genomes
truth_sample_rank	NA12878	VQSR	False	887	19.0	7.38	7.4	2540	2531	9	0	50799	50636	161	197151	6052	0.9968305214874894	0.20435293215543995	genomes
truth_sample_rank	NA12878	VQSR	False	891	20.0	7.36	7.38	2540	2530	10	0	53339	53166	171	194621	6042	0.996793970414534	0.21456331445959634	genomes
truth_sample_rank	NA12878	VQSR	False	895	21.0	7.34	7.36	2540	2531	9	0	55879	55697	180	192090	6033	0.9967786387959268	0.22477773248798363	genomes
truth_sample_rank	NA12878	VQSR	False	899	22.0	7.32	7.34	2540	2535	5	0	58419	58232	185	189555	6028	0.9968331136484243	0.2350082934132945	genomes
truth_sample_rank	NA12878	VQSR	False	903	23.0	7.3	7.32	2540	2534	6	0	60959	60766	191	187021	6022	0.9968666436996572	0.24523481861437443	genomes
truth_sample_rank	NA12878	VQSR	False	907	24.0	7.28	7.3	2540	2533	7	0	63499	63299	198	184488	6015	0.996881742444525	0.2554573080912235	genomes
truth_sample_rank	NA12878	VQSR	False	911	25.0	7.26	7.28	2540	2532	8	0	66039	65831	206	181956	6007	0.9968805366688371	0.2656757618438417	genomes
truth_sample_rank	NA12878	VQSR	False	915	26.0	7.24	7.26	2540	2531	9	0	68579	68362	215	179425	5998	0.9968648380652405	0.27589017987222897	genomes
truth_sample_rank	NA12878	VQSR	False	919	27.0	7.21	7.24	2540	2531	9	0	71119	70893	224	176894	5989	0.9968502608377744	0.28610459790061626	genomes
truth_sample_rank	NA12878	VQSR	False	923	28.0	7.19	7.21	2540	2534	6	0	73659	73427	230	174360	5983	0.9968774183037593	0.29633112310169624	genomes
truth_sample_rank	NA12878	VQSR	False	927	29.0	7.17	7.19	2540	2531	9	0	76199	75958	239	171829	5974	0.9968633935719254	0.3065455411300835	genomes
truth_sample_rank	NA12878	VQSR	False	931	30.0	7.15	7.17	2540	2532	8	0	78739	78490	247	169297	5966	0.9968629742052656	0.3167639948827017	genomes
truth_sample_rank	NA12878	VQSR	False	935	31.0	7.12	7.15	2540	2531	9	0	81279	81021	256	166766	5957	0.996850277446264	0.326978412911089	genomes
truth_sample_rank	NA12878	VQSR	False	939	32.0	7.1	7.12	2540	2529	11	0	83819	83550	267	164237	5946	0.9968144887075414	0.33718475949101445	genomes
truth_sample_rank	NA12878	VQSR	False	943	33.0	7.07	7.1	2540	2530	10	0	86359	86080	277	161707	5936	0.9967923850990655	0.34739514179517084	genomes
truth_sample_rank	NA12878	VQSR	False	947	34.0	7.05	7.07	2540	2532	7	1	88899	88612	284	159175	5929	0.9968052555795537	0.35761359554778904	genomes
truth_sample_rank	NA12878	VQSR	False	951	35.0	7.02	7.05	2540	2535	3	2	91439	91147	287	156640	5926	0.9968611238707702	0.36784415647309987	genomes
truth_sample_rank	NA12878	VQSR	False	955	36.0	7.0	7.02	2540	2531	9	0	93979	93678	296	154109	5917	0.9968501926064656	0.37805857450148717	genomes
truth_sample_rank	NA12878	VQSR	False	959	37.0	6.97	7.0	2540	2534	6	0	96519	96212	302	151575	5911	0.9968709202809956	0.38828509970256714	genomes
truth_sample_rank	NA12878	VQSR	False	963	38.0	6.94	6.97	2540	2534	5	1	99059	98746	307	149041	5906	0.9969006491474262	0.3985116249036471	genomes
truth_sample_rank	NA12878	VQSR	False	967	39.0	6.91	6.94	2540	2534	6	0	101599	101280	313	146507	5900	0.9969190790704084	0.408738150104727	genomes
truth_sample_rank	NA12878	VQSR	False	971	40.0	6.87	6.91	2540	2528	12	0	104139	103808	325	143979	5888	0.9968789912899849	0.41894046096042165	genomes
truth_sample_rank	NA12878	VQSR	False	975	41.0	6.84	6.87	2540	2537	3	0	106679	106345	328	141442	5885	0.996925182567285	0.4291790933341943	genomes
truth_sample_rank	NA12878	VQSR	False	979	42.0	6.8	6.84	2540	2534	6	0	109219	108879	334	138908	5879	0.9969417560180565	0.43940561853527427	genomes
truth_sample_rank	NA12878	VQSR	False	983	43.0	6.77	6.8	2540	2535	4	1	111759	111414	338	136373	5875	0.9969754456296084	0.4496361794605851	genomes
truth_sample_rank	NA12878	VQSR	False	987	44.0	6.73	6.77	2540	2529	11	0	114299	113943	349	133844	5864	0.9969464179470129	0.4598425260405106	genomes
truth_sample_rank	NA12878	VQSR	False	991	45.0	6.68	6.73	2540	2527	13	0	116839	116470	362	131317	5851	0.9969015338263489	0.47004080117197433	genomes
truth_sample_rank	NA12878	VQSR	False	995	46.0	6.64	6.68	2540	2535	5	0	119379	119005	367	128782	5846	0.9969255771872801	0.48027136209728516	genomes
truth_sample_rank	NA12878	VQSR	False	999	47.0	6.59	6.64	2540	2521	19	0	121919	121526	386	126261	5827	0.9968337817442089	0.4904454228833635	genomes
truth_sample_rank	NA12878	VQSR	False	1003	48.0	6.53	6.59	2540	2526	12	2	124459	124052	398	123735	5815	0.9968019284853354	0.5006396622905963	genomes
truth_sample_rank	NA12878	VQSR	False	1007	49.0	6.48	6.53	2540	2523	16	1	126999	126575	414	121212	5799	0.9967398751072928	0.5108217945251365	genomes
truth_sample_rank	NA12878	VQSR	False	1011	50.0	6.42	6.48	2540	2523	16	1	129539	129098	430	118689	5783	0.9966802544623556	0.5210039267596767	genomes
truth_sample_rank	NA12878	VQSR	False	1015	51.0	6.36	6.42	2540	2511	29	0	132079	131609	459	116178	5754	0.9965245176727141	0.5311376303034461	genomes
truth_sample_rank	NA12878	VQSR	False	1019	52.0	6.3	6.36	2541	2516	23	2	134620	134125	482	113662	5731	0.9964192055390879	0.54129151246837	genomes
truth_sample_rank	NA12878	VQSR	False	1023	53.0	6.23	6.3	2539	2515	24	0	137159	136640	506	111147	5707	0.9963105012176804	0.551441358909063	genomes
truth_sample_rank	NA12878	VQSR	False	1027	54.0	6.16	6.23	2540	2500	39	1	139699	139140	545	108647	5668	0.9960983641765401	0.5615306694862927	genomes
truth_sample_rank	NA12878	VQSR	False	1031	55.0	6.1	6.16	2540	2498	41	1	142239	141638	586	106149	5627	0.9958797390032624	0.5716119086150605	genomes
truth_sample_rank	NA12878	VQSR	False	1035	56.0	6.03	6.1	2540	2495	45	0	144779	144133	631	103654	5582	0.995641181509215	0.5816810405711357	genomes
truth_sample_rank	NA12878	VQSR	False	1039	57.0	5.96	6.03	2540	2499	41	0	147319	146632	672	101155	5541	0.9954380057568023	0.5917663154241345	genomes
truth_sample_rank	NA12878	VQSR	False	1043	58.0	5.9	5.96	2541	2471	69	1	149860	149103	741	98684	5472	0.9950548570513333	0.6017385899986682	genomes
truth_sample_rank	NA12878	VQSR	False	1047	59.0	5.83	5.9	2539	2481	58	0	152399	151584	799	96203	5414	0.9947566329577446	0.6117512218155109	genomes
truth_sample_rank	NA12878	VQSR	False	1051	60.0	5.76	5.83	2540	2480	60	0	154939	154064	859	93723	5354	0.9944553100572543	0.6217598179081227	genomes
truth_sample_rank	NA12878	VQSR	False	1055	61.0	5.68	5.76	2540	2492	48	0	157479	156556	907	91231	5306	0.9942399166788388	0.6318168426915052	genomes
truth_sample_rank	NA12878	VQSR	False	1059	62.0	5.61	5.68	2540	2479	60	1	160019	159035	967	88752	5246	0.9939563255459307	0.6418214030598861	genomes
truth_sample_rank	NA12878	VQSR	False	1063	63.0	5.53	5.61	2540	2495	44	1	162559	161530	1011	86257	5202	0.9937800308845153	0.6518905350159613	genomes
truth_sample_rank	NA12878	VQSR	False	1067	64.0	5.45	5.53	2540	2475	65	0	165099	164005	1076	83782	5137	0.9934819876303148	0.6618789524874187	genomes
truth_sample_rank	NA12878	VQSR	False	1071	65.0	5.36	5.45	2540	2481	58	1	167639	166486	1134	81301	5079	0.9932346975301277	0.6718915843042613	genomes
truth_sample_rank	NA12878	VQSR	False	1075	66.0	5.27	5.36	2540	2483	56	1	170179	168969	1190	78818	5023	0.9930065409411197	0.6819122875695658	genomes
truth_sample_rank	NA12878	VQSR	False	1079	67.0	5.16	5.27	2540	2477	61	2	172719	171446	1251	76341	4962	0.9927560988320585	0.6919087764894849	genomes
truth_sample_rank	NA12878	VQSR	False	1083	68.0	5.05	5.16	2540	2465	72	3	175259	173911	1323	73876	4890	0.9924500953011401	0.7018568367186333	genomes
truth_sample_rank	NA12878	VQSR	False	1087	69.0	4.94	5.05	2540	2493	46	1	177799	176404	1369	71383	4844	0.9922991680401411	0.7119178972262468	genomes
truth_sample_rank	NA12878	VQSR	False	1091	70.0	4.83	4.94	2540	2490	47	3	180339	178894	1416	68893	4797	0.9921468581886751	0.7219668505611675	genomes
truth_sample_rank	NA12878	VQSR	False	1095	71.0	4.71	4.83	2540	2490	48	2	182879	181384	1464	66403	4749	0.9919933496674834	0.7320158038960882	genomes
truth_sample_rank	NA12878	VQSR	False	1099	72.0	4.58	4.71	2540	2485	55	0	185419	183869	1519	63918	4694	0.991806373659568	0.7420445786098544	genomes
truth_sample_rank	NA12878	VQSR	False	1103	73.0	4.45	4.58	2540	2492	48	0	187959	186361	1567	61426	4646	0.9916617002256183	0.752101603393237	genomes
truth_sample_rank	NA12878	VQSR	False	1107	74.0	4.29	4.44	2540	2490	47	3	190499	188851	1614	58936	4599	0.9915260021526264	0.7621505567281577	genomes
truth_sample_rank	NA12878	VQSR	False	1111	75.0	4.12	4.29	2540	2488	51	1	193039	191339	1665	56448	4548	0.9913732357878593	0.7721914386146166	genomes
truth_sample_rank	NA12878	VQSR	False	1115	76.0	3.94	4.12	2540	2455	82	3	195579	193794	1747	53993	4466	0.9910658122848917	0.7820991416014561	genomes
truth_sample_rank	NA12878	VQSR	False	1119	77.0	3.72	3.94	2540	2483	56	1	198119	196277	1803	51510	4410	0.9908976171243942	0.7921198448667606	genomes
truth_sample_rank	NA12878	VQSR	False	1123	78.0	3.5	3.72	2540	2474	63	3	200659	198751	1866	49036	4347	0.990698694527383	0.8021042266139871	genomes
truth_sample_rank	NA12878	VQSR	False	1127	79.0	3.33	3.5	2540	2480	54	6	203199	201231	1920	46556	4293	0.9905489020482301	0.8121128227065988	genomes
truth_sample_rank	NA12878	VQSR	False	1131	80.0	3.17	3.33	2540	2468	65	7	205739	203699	1985	44088	4228	0.9903492736430641	0.8220729901084399	genomes
truth_sample_rank	NA12878	VQSR	False	1135	81.0	3.02	3.17	2540	2470	66	4	208279	206169	2051	41618	4162	0.9901498415137835	0.8320412289587428	genomes
truth_sample_rank	NA12878	VQSR	False	1139	82.0	2.85	3.02	2540	2486	50	4	210819	208655	2101	39132	4112	0.9900311260414887	0.84207403939674	genomes
truth_sample_rank	NA12878	VQSR	False	1143	83.0	2.69	2.85	2540	2463	69	8	213359	211118	2170	36669	4043	0.9898259630171411	0.8520140281774266	genomes
truth_sample_rank	NA12878	VQSR	False	1147	84.0	2.51	2.69	2540	2478	56	6	215899	213596	2226	34191	3987	0.9896859448990372	0.8620145528215766	genomes
truth_sample_rank	NA12878	VQSR	False	1151	85.0	2.3	2.51	2540	2464	64	12	218439	216060	2290	31727	3923	0.9895122509732082	0.8719585773264942	genomes
truth_sample_rank	NA12878	VQSR	False	1155	86.0	2.07	2.3	2540	2458	71	11	220979	218518	2361	29269	3852	0.9893108896726261	0.8818783874860263	genomes
truth_sample_rank	NA12878	VQSR	False	1159	87.0	1.84	2.07	2540	2452	80	8	223519	220970	2441	26817	3772	0.9890739489103043	0.8917739833001731	genomes
truth_sample_rank	NA12878	VQSR	False	1163	88.0	1.6	1.84	2540	2455	79	6	226059	223425	2520	24362	3693	0.9888468432583151	0.9016816862870126	genomes
truth_sample_rank	NA12878	VQSR	False	1167	89.0	1.37	1.6	2540	2432	94	14	228599	225857	2614	21930	3599	0.9885587229889132	0.9114965676165416	genomes
truth_sample_rank	NA12878	VQSR	False	1171	90.0	1.13	1.37	2540	2440	92	8	231139	228297	2706	19490	3507	0.9882858664173193	0.9213437347399177	genomes
truth_sample_rank	NA12878	VQSR	False	1175	91.0	0.9	1.13	2540	2433	88	19	233679	230730	2794	17057	3419	0.9880354909987838	0.9311626517936776	genomes
truth_sample_rank	NA12878	VQSR	False	1179	92.0	0.652	0.9	2540	2437	88	15	236219	233167	2882	14620	3331	0.9877906705811081	0.9409977117443611	genomes
truth_sample_rank	NA12878	VQSR	False	1183	93.0	0.373	0.652	2540	2440	79	21	238759	235607	2961	12180	3252	0.9875884443848295	0.9508448788677372	genomes
truth_sample_rank	NA12878	VQSR	False	1187	94.0	-0.1007	0.373	2540	2418	111	11	241299	238025	3072	9762	3141	0.9872582404592343	0.9606032600580338	genomes
truth_sample_rank	NA12878	VQSR	False	1191	95.0	-0.9182	-0.1008	2540	2346	160	34	243839	240371	3232	7416	2981	0.9867325115043739	0.970071069103706	genomes
truth_sample_rank	NA12878	VQSR	False	1195	96.0	-2.065	-0.9187	2540	2168	330	42	246379	242539	3562	5248	2651	0.9855262676705905	0.9788205192362796	genomes
truth_sample_rank	NA12878	VQSR	False	1199	97.0	-4.934	-2.066	2540	1612	902	26	248919	244151	4464	3636	1749	0.982044526677795	0.9853261066964772	genomes
truth_sample_rank	NA12878	VQSR	False	1203	98.0	-950.6	-4.936	2540	347	1403	790	251459	244498	5867	3289	346	0.9765662133285403	0.9867265030045967	genomes
truth_sample_rank	NA12878	VQSR	False	1207	99.0	-1.0	-1.0	2540	95	346	2099	253999	244593	6213	3194	0	0.9752278653620727	0.9871098968065314	genomes
truth_sample_rank	NA12878	VQSR	False	1211	100.0	-1.0	-1.0	1	0	0	1	254000	244593	6213	3194	0	0.9752278653620727	0.9871098968065314	genomes
truth_sample_rank	NA12878	VQSR	True	1215	0.0	23.1	162.54	31450	31309	141	0	31450	31309	141	3083516	30063	0.995516693163752	0.010051608035764449	genomes
truth_sample_rank	NA12878	VQSR	True	1219	1.0	22.99	23.1	31450	31449	0	1	62900	62758	141	3052067	30063	0.9977583109429403	0.020148162416829197	genomes
truth_sample_rank	NA12878	VQSR	True	1223	2.0	22.9	22.99	31450	31447	3	0	94350	94205	144	3020620	30060	0.9984737517090801	0.030244074707246795	genomes
truth_sample_rank	NA12878	VQSR	True	1227	3.0	22.83	22.9	31451	31449	1	1	125801	125654	145	2989171	30059	0.9988473676261338	0.04034062908831154	genomes
truth_sample_rank	NA12878	VQSR	True	1231	4.0	22.76	22.83	31450	31446	1	3	157251	157100	146	2957725	30058	0.9990715185123946	0.05043622033340557	genomes
truth_sample_rank	NA12878	VQSR	True	1235	5.0	22.7	22.76	31450	31450	0	0	188701	188550	146	2926275	30058	0.9992262687073388	0.06053309575979389	genomes
truth_sample_rank	NA12878	VQSR	True	1239	6.0	22.65	22.7	31451	31451	0	0	220152	220001	146	2894824	30058	0.9993368067700219	0.07063029223150578	genomes
truth_sample_rank	NA12878	VQSR	True	1243	7.0	22.59	22.65	31450	31448	1	1	251602	251449	147	2863376	30057	0.9994157299798089	0.08072652556724695	genomes
truth_sample_rank	NA12878	VQSR	True	1247	8.0	22.55	22.59	31450	31449	0	1	283052	282898	147	2831927	30057	0.9994806479535057	0.09082307994831171	genomes
truth_sample_rank	NA12878	VQSR	True	1251	9.0	22.5	22.55	31450	31446	3	1	314502	314344	150	2800481	30054	0.9995230433648973	0.10091867119340572	genomes
truth_sample_rank	NA12878	VQSR	True	1255	10.0	22.46	22.5	31451	31447	4	0	345953	345791	154	2769034	30050	0.9995548425327726	0.11101458348382333	genomes
truth_sample_rank	NA12878	VQSR	True	1259	11.0	22.42	22.46	31450	31448	1	1	377403	377239	155	2737586	30049	0.9995892886479383	0.1211108168195645	genomes
truth_sample_rank	NA12878	VQSR	True	1263	12.0	22.38	22.42	31450	31448	2	0	408853	408687	157	2706138	30047	0.9996159904511256	0.13120705015530568	genomes
truth_sample_rank	NA12878	VQSR	True	1267	13.0	22.34	22.38	31451	31447	2	2	440304	440134	159	2674691	30045	0.9996388768388323	0.14130296244572327	genomes
truth_sample_rank	NA12878	VQSR	True	1271	14.0	22.31	22.34	31450	31448	1	1	471754	471582	160	2643243	30044	0.999660831556232	0.15139919578146444	genomes
truth_sample_rank	NA12878	VQSR	True	1275	15.0	22.27	22.31	31450	31448	0	2	503204	503030	160	2611795	30044	0.9996820286571673	0.16149542911720563	genomes
truth_sample_rank	NA12878	VQSR	True	1279	16.0	22.24	22.27	31450	31447	3	0	534654	534477	163	2580348	30041	0.9996951219512196	0.17159134140762322	genomes
truth_sample_rank	NA12878	VQSR	True	1283	17.0	22.2	22.24	31451	31449	2	0	566105	565926	165	2548899	30039	0.9997085274275691	0.18168789578868796	genomes
truth_sample_rank	NA12878	VQSR	True	1287	18.0	22.17	22.2	31450	31448	1	1	597555	597374	166	2517451	30038	0.9997221943300867	0.19178412912442913	genomes
truth_sample_rank	NA12878	VQSR	True	1291	19.0	22.14	22.17	31450	31448	1	1	629005	628822	167	2486003	30037	0.9997344945619081	0.20188036246017033	genomes
truth_sample_rank	NA12878	VQSR	True	1295	20.0	22.11	22.14	31451	31448	2	1	660456	660270	169	2454555	30035	0.9997441095998267	0.2119765957959115	genomes
truth_sample_rank	NA12878	VQSR	True	1299	21.0	22.08	22.11	31450	31447	1	2	691906	691717	170	2423108	30034	0.9997542951377898	0.22207250808632908	genomes
truth_sample_rank	NA12878	VQSR	True	1303	22.0	22.05	22.08	31450	31448	2	0	723356	723165	172	2391660	30032	0.9997622131869378	0.23216874142207025	genomes
truth_sample_rank	NA12878	VQSR	True	1307	23.0	22.02	22.05	31450	31443	3	4	754806	754608	175	2360217	30029	0.9997681452814915	0.24226336953119357	genomes
truth_sample_rank	NA12878	VQSR	True	1311	24.0	21.99	22.02	31451	31449	0	2	786257	786057	175	2328768	30029	0.9997774193876616	0.2523599239122583	genomes
truth_sample_rank	NA12878	VQSR	True	1315	25.0	21.96	21.99	31450	31445	4	1	817707	817502	179	2297323	30025	0.9997810882238917	0.2624551941120288	genomes
truth_sample_rank	NA12878	VQSR	True	1319	26.0	21.93	21.96	31450	31446	2	2	849157	848948	181	2265877	30023	0.999786840397631	0.2725507853571228	genomes
truth_sample_rank	NA12878	VQSR	True	1323	27.0	21.91	21.93	31451	31448	2	1	880608	880396	183	2234429	30021	0.9997921821892187	0.28264701869286396	genomes
truth_sample_rank	NA12878	VQSR	True	1327	28.0	21.88	21.91	31450	31447	2	1	912058	911843	185	2202982	30019	0.9997971553504936	0.2927429309832816	genomes
truth_sample_rank	NA12878	VQSR	True	1331	29.0	21.85	21.88	31450	31447	1	2	943508	943290	186	2171535	30018	0.99980285667044	0.30283884327369914	genomes
truth_sample_rank	NA12878	VQSR	True	1335	30.0	21.83	21.85	31450	31443	4	3	974958	974733	190	2140092	30014	0.9998051128140376	0.31293347138282246	genomes
truth_sample_rank	NA12878	VQSR	True	1339	31.0	21.8	21.83	31451	31448	2	1	1006409	1006181	192	2108644	30012	0.9998092158672779	0.3230297047185636	genomes
truth_sample_rank	NA12878	VQSR	True	1343	32.0	21.77	21.8	31450	31449	0	1	1037859	1037630	192	2077195	30012	0.9998149971767798	0.3331262590996284	genomes
truth_sample_rank	NA12878	VQSR	True	1347	33.0	21.75	21.77	31450	31444	3	3	1069309	1069074	195	2045751	30009	0.9998176324199055	0.34322120825407526	genomes
truth_sample_rank	NA12878	VQSR	True	1351	34.0	21.72	21.75	31451	31449	1	1	1100760	1100523	196	2014302	30008	0.9998219345718571	0.35331776263514003	genomes
truth_sample_rank	NA12878	VQSR	True	1355	35.0	21.69	21.72	31450	31447	1	2	1132210	1131970	197	1982855	30007	0.9998259974014434	0.3634136749255576	genomes
truth_sample_rank	NA12878	VQSR	True	1359	36.0	21.67	21.69	31450	31447	0	3	1163660	1163417	197	1951408	30007	0.9998306998712632	0.3735095872159752	genomes
truth_sample_rank	NA12878	VQSR	True	1363	37.0	21.64	21.67	31450	31444	4	2	1195110	1194861	201	1919964	30003	0.9998318078894651	0.3836045363704221	genomes
truth_sample_rank	NA12878	VQSR	True	1367	38.0	21.61	21.64	31451	31450	1	0	1226561	1226311	202	1888514	30002	0.9998353054553845	0.3937014117968104	genomes
truth_sample_rank	NA12878	VQSR	True	1371	39.0	21.59	21.61	31450	31448	0	2	1258011	1257759	202	1857066	30002	0.999839422684805	0.40379764513255156	genomes
truth_sample_rank	NA12878	VQSR	True	1375	40.0	21.56	21.59	31450	31442	7	1	1289461	1289201	209	1825624	29995	0.9998379103621036	0.41389195219635133	genomes
truth_sample_rank	NA12878	VQSR	True	1379	41.0	21.53	21.56	31451	31444	5	2	1320912	1320645	214	1794180	29990	0.9998379842208744	0.4239869013507982	genomes
truth_sample_rank	NA12878	VQSR	True	1383	42.0	21.51	21.53	31450	31445	4	1	1352362	1352090	218	1762735	29986	0.999838794120866	0.43408217155056866	genomes
truth_sample_rank	NA12878	VQSR	True	1387	43.0	21.48	21.51	31450	31445	4	1	1383812	1383535	222	1731290	29982	0.9998395672072481	0.44417744175033913	genomes
truth_sample_rank	NA12878	VQSR	True	1391	44.0	21.45	21.48	31450	31447	2	1	1415262	1414982	224	1699843	29980	0.9998417191560804	0.4542733540407567	genomes
truth_sample_rank	NA12878	VQSR	True	1395	45.0	21.42	21.45	31451	31446	4	1	1446713	1446428	228	1668397	29976	0.9998423951513007	0.4643689452858507	genomes
truth_sample_rank	NA12878	VQSR	True	1399	46.0	21.39	21.42	31450	31443	6	1	1478163	1477871	234	1636954	29970	0.9998416891898749	0.474463573394974	genomes
truth_sample_rank	NA12878	VQSR	True	1403	47.0	21.36	21.39	31450	31445	4	1	1509613	1509316	238	1605509	29966	0.9998423375381073	0.4845588435947445	genomes
truth_sample_rank	NA12878	VQSR	True	1407	48.0	21.33	21.36	31451	31450	1	0	1541064	1540766	239	1574059	29965	0.9998449064084802	0.4946557190211328	genomes
truth_sample_rank	NA12878	VQSR	True	1411	49.0	21.3	21.33	31450	31443	1	6	1572514	1572209	240	1542616	29964	0.9998473718384507	0.5047503471302561	genomes
truth_sample_rank	NA12878	VQSR	True	1415	50.0	21.27	21.3	31450	31442	5	3	1603964	1603651	245	1511174	29959	0.9998472469536678	0.5148446541940559	genomes
truth_sample_rank	NA12878	VQSR	True	1419	51.0	21.24	21.27	31450	31449	0	1	1635414	1635100	245	1479725	29959	0.99985018451764	0.5249412085751206	genomes
truth_sample_rank	NA12878	VQSR	True	1423	52.0	21.2	21.24	31451	31449	1	1	1666865	1666549	246	1448276	29958	0.9998524113643249	0.5350377629561853	genomes
truth_sample_rank	NA12878	VQSR	True	1427	53.0	21.17	21.2	31450	31442	6	2	1698315	1697991	252	1416834	29952	0.9998516113418398	0.5451320700199851	genomes
truth_sample_rank	NA12878	VQSR	True	1431	54.0	21.14	21.17	31450	31444	3	3	1729765	1729435	255	1385390	29949	0.999852574738826	0.555227019174432	genomes
truth_sample_rank	NA12878	VQSR	True	1435	55.0	21.1	21.14	31451	31444	3	4	1761216	1760879	258	1353946	29946	0.9998535037308285	0.5653219683288788	genomes
truth_sample_rank	NA12878	VQSR	True	1439	56.0	21.07	21.1	31450	31446	2	2	1792666	1792325	260	1322500	29944	0.9998549580633554	0.5754175595739729	genomes
truth_sample_rank	NA12878	VQSR	True	1443	57.0	21.03	21.07	31450	31446	3	1	1824116	1823771	263	1291054	29941	0.9998558140911847	0.5855131508190669	genomes
truth_sample_rank	NA12878	VQSR	True	1447	58.0	21.0	21.03	31451	31444	6	1	1855567	1855215	269	1259610	29935	0.999855024349442	0.5956080999735137	genomes
truth_sample_rank	NA12878	VQSR	True	1451	59.0	20.96	21.0	31450	31441	7	2	1887017	1886656	276	1228169	29928	0.9998537308180687	0.6057020859919899	genomes
truth_sample_rank	NA12878	VQSR	True	1455	60.0	20.92	20.96	31450	31440	7	3	1918467	1918096	283	1196729	29921	0.9998524796195121	0.6157957509651425	genomes
truth_sample_rank	NA12878	VQSR	True	1459	61.0	20.87	20.92	31450	31442	6	2	1949917	1949538	289	1165287	29915	0.9998517817221733	0.6258900580289423	genomes
truth_sample_rank	NA12878	VQSR	True	1463	62.0	20.83	20.87	31451	31439	10	2	1981368	1980977	299	1133848	29905	0.9998490871539352	0.6359834019567713	genomes
truth_sample_rank	NA12878	VQSR	True	1467	63.0	20.78	20.83	31450	31439	10	1	2012818	2012416	309	1102409	29895	0.9998464767914146	0.6460767458846003	genomes
truth_sample_rank	NA12878	VQSR	True	1471	64.0	20.73	20.78	31450	31442	5	3	2044268	2043858	314	1070967	29890	0.9998463925736191	0.6561710529484	genomes
truth_sample_rank	NA12878	VQSR	True	1475	65.0	20.67	20.73	31450	31442	5	3	2075718	2075300	319	1039525	29885	0.999846310907734	0.6662653600121997	genomes
truth_sample_rank	NA12878	VQSR	True	1479	66.0	20.61	20.67	31451	31447	4	0	2107169	2106747	323	1008078	29881	0.9998467065640914	0.6763612723026173	genomes
truth_sample_rank	NA12878	VQSR	True	1483	67.0	20.54	20.61	31450	31439	11	0	2138619	2138186	334	976639	29870	0.9998438172193854	0.6864546162304463	genomes
truth_sample_rank	NA12878	VQSR	True	1487	68.0	20.46	20.54	31450	31438	8	4	2170069	2169624	342	945201	29862	0.9998423938439589	0.6965476391129518	genomes
truth_sample_rank	NA12878	VQSR	True	1491	69.0	20.38	20.46	31451	31434	11	6	2201520	2201058	353	913767	29851	0.999839648298296	0.7066393778141629	genomes
truth_sample_rank	NA12878	VQSR	True	1495	70.0	20.28	20.38	31450	31436	10	4	2232970	2232494	363	882331	29841	0.9998374280126313	0.7167317586060212	genomes
truth_sample_rank	NA12878	VQSR	True	1499	71.0	20.16	20.28	31450	31427	20	3	2264420	2263921	383	850904	29821	0.9998308531009971	0.7268212499899673	genomes
truth_sample_rank	NA12878	VQSR	True	1503	72.0	20.04	20.16	31451	31436	12	3	2295871	2295357	395	819468	29809	0.9998279430879293	0.7369136307818256	genomes
truth_sample_rank	NA12878	VQSR	True	1507	73.0	19.91	20.04	31450	31433	16	1	2327321	2326790	411	788035	29793	0.9998233929944169	0.7470050484377132	genomes
truth_sample_rank	NA12878	VQSR	True	1511	74.0	19.79	19.91	31450	31430	19	1	2358771	2358220	430	756605	29774	0.9998176923239989	0.7570955029576301	genomes
truth_sample_rank	NA12878	VQSR	True	1515	75.0	19.66	19.79	31450	31441	8	1	2390221	2389661	438	725164	29766	0.9998167439926129	0.7671894889761062	genomes
truth_sample_rank	NA12878	VQSR	True	1519	76.0	19.51	19.66	31451	31434	17	0	2421672	2421095	455	693730	29749	0.9998121038178026	0.7772812276773173	genomes
truth_sample_rank	NA12878	VQSR	True	1523	77.0	19.36	19.51	31450	31433	13	4	2453122	2452528	468	662297	29736	0.9998092128972081	0.787372645333205	genomes
truth_sample_rank	NA12878	VQSR	True	1527	78.0	19.22	19.36	31450	31436	12	2	2484572	2483964	480	630861	29724	0.9998067978187474	0.7974650261250632	genomes
truth_sample_rank	NA12878	VQSR	True	1531	79.0	19.06	19.22	31451	31423	21	7	2516023	2515387	501	599438	29703	0.9998008655393245	0.807553233327715	genomes
truth_sample_rank	NA12878	VQSR	True	1535	80.0	18.89	19.06	31450	31428	17	5	2547473	2546815	518	568010	29686	0.9997966500649895	0.8176430457569848	genomes
truth_sample_rank	NA12878	VQSR	True	1539	81.0	18.7	18.89	31450	31418	26	6	2578923	2578233	544	536592	29660	0.9997890472886953	0.8277296477330187	genomes
truth_sample_rank	NA12878	VQSR	True	1543	82.0	18.5	18.7	31450	31407	38	5	2610373	2609640	582	505185	29622	0.9997770304594782	0.8378127182104934	genomes
truth_sample_rank	NA12878	VQSR	True	1547	83.0	18.29	18.5	31451	31404	35	12	2641824	2641044	617	473781	29587	0.9997664348302072	0.8478948255519974	genomes
truth_sample_rank	NA12878	VQSR	True	1551	84.0	18.05	18.29	31450	31398	48	4	2673274	2672442	665	442383	29539	0.9997512258207397	0.8579750066215598	genomes
truth_sample_rank	NA12878	VQSR	True	1555	85.0	17.75	18.05	31450	31401	42	7	2704724	2703843	707	410982	29497	0.9997385886746409	0.868056150827093	genomes
truth_sample_rank	NA12878	VQSR	True	1559	86.0	17.41	17.75	31451	31405	37	9	2736175	2735248	744	379577	29460	0.9997280693803198	0.8781385792139206	genomes
truth_sample_rank	NA12878	VQSR	True	1563	87.0	17.06	17.41	31450	31393	49	8	2767625	2766641	793	348184	29411	0.9997134529676227	0.8882171550568652	genomes
truth_sample_rank	NA12878	VQSR	True	1567	88.0	16.65	17.06	31450	31401	43	6	2799075	2798042	836	316783	29368	0.9997013088816304	0.8982982992623983	genomes
truth_sample_rank	NA12878	VQSR	True	1571	89.0	15.98	16.65	31450	31364	71	15	2830525	2829406	907	285419	29297	0.9996795407433736	0.9083675647909594	genomes
truth_sample_rank	NA12878	VQSR	True	1575	90.0	14.55	15.98	31451	31181	233	37	2861976	2860587	1140	254238	29064	0.9996016391500657	0.9183780790253064	genomes
truth_sample_rank	NA12878	VQSR	True	1579	91.0	5.49	14.55	31450	29472	1822	156	2893426	2890059	2962	224766	27242	0.9989761567579357	0.9278399268016663	genomes
truth_sample_rank	NA12878	VQSR	True	1583	92.0	1.67	5.49	31450	31049	268	133	2924876	2921108	3230	193717	26974	0.9988954765146847	0.9378080630533016	genomes
truth_sample_rank	NA12878	VQSR	True	1587	93.0	0.84	1.67	31451	31296	98	57	2956327	2952404	3328	162421	26876	0.9988740521806443	0.9478554974998595	genomes
truth_sample_rank	NA12878	VQSR	True	1591	94.0	0.332	0.84	31450	31324	72	54	2987777	2983728	3400	131097	26804	0.9988617829567397	0.9579119212154776	genomes
truth_sample_rank	NA12878	VQSR	True	1595	95.0	-0.2519	0.332	31450	31353	59	38	3019227	3015081	3459	99744	26745	0.9988540817746328	0.9679776552454793	genomes
truth_sample_rank	NA12878	VQSR	True	1599	96.0	-2.319	-0.2519	31450	30903	408	139	3050677	3045984	3867	68841	26337	0.9987320692060039	0.9778989188798729	genomes
truth_sample_rank	NA12878	VQSR	True	1603	97.0	-9.071	-2.319	31451	27153	4196	102	3082128	3073137	8063	41688	22141	0.9973831624042581	0.9866162625508657	genomes
truth_sample_rank	NA12878	VQSR	True	1607	98.0	-20.82	-9.071	31450	27395	3905	150	3113578	3100532	11968	14293	18236	0.996154859437751	0.9954112991901631	genomes
truth_sample_rank	NA12878	VQSR	True	1611	99.0	-16980.0	-20.82	31450	10796	18235	2419	3145028	3111328	30203	3497	1	0.990385897831344	0.9988773045034632	genomes
truth_sample_rank	NA12878	VQSR	True	1615	100.0	-1.0	-1.0	1	0	1	0	3145029	3111328	30204	3497	0	0.990385582575635	0.9988773045034632	genomes
truth_sample_rank	syndip	RF	False	812	0.0	0.9617872044416576	0.9617872044416576	1718	1678	39	1	1718	1678	39	151338	18773	0.9772859638905067	0.01096617347205521	genomes
truth_sample_rank	syndip	RF	False	816	1.0	0.9617872044416576	0.9617872044416576	1718	1677	40	1	3436	3355	79	149661	18733	0.9769947582993593	0.021925811679824332	genomes
truth_sample_rank	syndip	RF	False	820	2.0	0.9617872044416576	0.9617872044416576	1718	1674	43	1	5154	5029	122	147987	18690	0.9763152785866822	0.03286584409473519	genomes
truth_sample_rank	syndip	RF	False	824	3.0	0.9617872044416576	0.9617872044416576	1719	1672	47	0	6873	6701	169	146315	18643	0.9754002911208152	0.04379280598107387	genomes
truth_sample_rank	syndip	RF	False	828	4.0	0.9614095443591661	0.9617872044416576	1718	1680	36	2	8591	8381	205	144635	18607	0.9761239226648032	0.05477204998170126	genomes
truth_sample_rank	syndip	RF	False	832	5.0	0.9614095443591661	0.9614095443591661	1718	1659	59	0	10309	10040	264	142976	18548	0.9743788819875776	0.06561405343232081	genomes
truth_sample_rank	syndip	RF	False	836	6.0	0.9614095443591661	0.9614095443591661	1718	1676	42	0	12027	11716	306	141300	18506	0.974546664448511	0.07656715637580384	genomes
truth_sample_rank	syndip	RF	False	840	7.0	0.9614095443591661	0.9614095443591661	1719	1667	50	2	13746	13383	356	139633	18456	0.9740883615983696	0.08746144194071208	genomes
truth_sample_rank	syndip	RF	False	844	8.0	0.9614095443591661	0.9614095443591661	1718	1669	49	0	15464	15052	405	137964	18407	0.9737982790968494	0.0983687980341925	genomes
truth_sample_rank	syndip	RF	False	848	9.0	0.9614095443591661	0.9614095443591661	1718	1667	51	0	17182	16719	456	136297	18356	0.9734497816593887	0.10926308359910075	genomes
truth_sample_rank	syndip	RF	False	852	10.0	0.9614095443591661	0.9614095443591661	1719	1669	50	0	18901	18388	506	134628	18306	0.973219011326347	0.12017043969258116	genomes
truth_sample_rank	syndip	RF	False	856	11.0	0.9614095443591661	0.9614095443591661	1718	1681	36	1	20619	20069	542	132947	18270	0.9737033622822765	0.13115621895749463	genomes
truth_sample_rank	syndip	RF	False	860	12.0	0.9614095443591661	0.9614095443591661	1718	1664	53	1	22337	21733	595	131283	18217	0.9733518452167682	0.14203089872954464	genomes
truth_sample_rank	syndip	RF	False	864	13.0	0.9614095443591661	0.9614095443591661	1718	1671	46	1	24055	23404	641	129612	18171	0.9733416510709088	0.15295132535159722	genomes
truth_sample_rank	syndip	RF	False	868	14.0	0.9614095443591661	0.9614095443591661	1719	1662	57	0	25774	25066	698	127950	18114	0.9729079335506909	0.16381293459507504	genomes
truth_sample_rank	syndip	RF	False	872	15.0	0.9614095443591661	0.9614095443591661	1718	1678	40	0	27492	26744	738	126272	18074	0.9731460592387745	0.17477910806713023	genomes
truth_sample_rank	syndip	RF	False	876	16.0	0.9614095443591661	0.9614095443591661	1718	1663	55	0	29210	28407	793	124609	18019	0.9728424657534247	0.18564725257489412	genomes
truth_sample_rank	syndip	RF	False	880	17.0	0.9612564032264	0.9614095443591661	1719	1647	71	1	30929	30054	864	122962	17948	0.9720551135261013	0.19641083285408062	genomes
truth_sample_rank	syndip	RF	False	884	18.0	0.9610382745299405	0.9612564032264	1718	1637	73	8	32647	31691	937	121325	17875	0.971282334191492	0.20710906049040623	genomes
truth_sample_rank	syndip	RF	False	888	19.0	0.9610382745299405	0.9610382745299405	1718	1674	44	0	34365	33365	981	119651	17831	0.9714377220054737	0.2180490929053171	genomes
truth_sample_rank	syndip	RF	False	892	20.0	0.9608787431439086	0.9610382745299405	1718	1633	83	2	36083	34998	1064	118018	17748	0.9704952581664911	0.22872117948449835	genomes
truth_sample_rank	syndip	RF	False	896	21.0	0.9608787431439086	0.9608787431439086	1719	1575	142	2	37802	36573	1206	116443	17606	0.9680775033748908	0.23901422073508652	genomes
truth_sample_rank	syndip	RF	False	900	22.0	0.9607260839317334	0.9608787431439086	1718	1631	85	2	39520	38204	1291	114812	17521	0.9673123180149386	0.2496732367856956	genomes
truth_sample_rank	syndip	RF	False	904	23.0	0.9606606144474491	0.9607260839317334	1718	1622	96	0	41238	39826	1387	113190	17425	0.9663455705723922	0.2602734354577299	genomes
truth_sample_rank	syndip	RF	False	908	24.0	0.9606606144474491	0.9606606144474491	1718	1684	34	0	42956	41510	1421	111506	17391	0.9669003750203815	0.2712788205155017	genomes
truth_sample_rank	syndip	RF	False	912	25.0	0.9603744618862137	0.9606606144474491	1719	1652	66	1	44675	43162	1487	109854	17325	0.966695782660306	0.28207507711611857	genomes
truth_sample_rank	syndip	RF	False	916	26.0	0.9601298132321916	0.9603744618862137	1718	1645	72	1	46393	44807	1559	108209	17253	0.96637622395721	0.2928255868667329	genomes
truth_sample_rank	syndip	RF	False	920	27.0	0.9578061650275391	0.9601298132321916	1718	1598	109	11	48111	46405	1668	106611	17144	0.9653027687059264	0.3032689391959011	genomes
truth_sample_rank	syndip	RF	False	924	28.0	0.9574285049450477	0.9578061650275391	1719	1674	44	1	49830	48079	1712	104937	17100	0.9656162760338214	0.31420897161081196	genomes
truth_sample_rank	syndip	RF	False	928	29.0	0.9572753638122815	0.9574285049450477	1718	1673	45	0	51548	49752	1757	103264	17055	0.9658894562115359	0.3251424687614367	genomes
truth_sample_rank	syndip	RF	False	932	30.0	0.9526576966515207	0.9572753638122815	1718	1591	122	5	53266	51343	1879	101673	16933	0.9646950509187929	0.3355400742406023	genomes
truth_sample_rank	syndip	RF	False	936	31.0	0.9461995507117654	0.9526576966515207	1718	1560	139	19	54984	52903	2018	100113	16794	0.9632563136141002	0.34573508652689916	genomes
truth_sample_rank	syndip	RF	False	940	32.0	0.945821890629274	0.9461995507117654	1719	1675	43	1	56703	54578	2061	98438	16751	0.9636116456858348	0.3566816542060961	genomes
truth_sample_rank	syndip	RF	False	944	33.0	0.945821890629274	0.945821890629274	1718	1677	41	0	58421	56255	2102	96761	16710	0.963980327981219	0.36764129241386523	genomes
truth_sample_rank	syndip	RF	False	948	34.0	0.945821890629274	0.945821890629274	1718	1668	49	1	60139	57923	2151	95093	16661	0.9641941605353398	0.37854211324305953	genomes
truth_sample_rank	syndip	RF	False	952	35.0	0.9454506208000484	0.945821890629274	1719	1679	38	2	61858	59602	2189	93414	16623	0.964574128918451	0.38951482197940085	genomes
truth_sample_rank	syndip	RF	False	956	36.0	0.9446695225539362	0.9454506208000484	1718	1681	37	0	63576	61283	2226	91733	16586	0.9649498496276119	0.4005006012443143	genomes
truth_sample_rank	syndip	RF	False	960	37.0	0.9442918624714448	0.9446695225539362	1718	1634	84	0	65294	62917	2310	90099	16502	0.9645852177779141	0.41117922308778165	genomes
truth_sample_rank	syndip	RF	False	964	38.0	0.9421270037763911	0.9442918624714448	1718	1576	137	5	67012	64493	2447	88523	16365	0.9634448760083657	0.42147879960265594	genomes
truth_sample_rank	syndip	RF	False	968	39.0	0.9325909236048364	0.9421270037763911	1719	1549	131	39	68731	66042	2578	86974	16234	0.9624307781987759	0.4316019239818058	genomes
truth_sample_rank	syndip	RF	False	972	40.0	0.932213263522345	0.9325909236048364	1718	1608	78	32	70449	67650	2656	85366	16156	0.9622222854379427	0.4421106289538349	genomes
truth_sample_rank	syndip	RF	False	976	41.0	0.9320322698256294	0.932213263522345	1718	1616	96	6	72167	69266	2752	83750	16060	0.9617873309450415	0.45267161604015266	genomes
truth_sample_rank	syndip	RF	False	980	42.0	0.9314647004529114	0.9320322698256294	1719	1572	116	31	73886	70838	2868	82178	15944	0.9610886494993623	0.46294505149788256	genomes
truth_sample_rank	syndip	RF	False	984	43.0	0.9308852966224733	0.9314647004529114	1718	1577	112	29	75604	72415	2980	80601	15832	0.9604748325485775	0.4732511632770429	genomes
truth_sample_rank	syndip	RF	False	988	44.0	0.9298950923227814	0.9308852966224733	1718	1588	86	44	77322	74003	3066	79013	15746	0.9602174674642203	0.48362916296335023	genomes
truth_sample_rank	syndip	RF	False	992	45.0	0.9295194070642406	0.9298950923227814	1718	1602	92	24	79040	75605	3158	77411	15654	0.9599050315503472	0.49409865634966277	genomes
truth_sample_rank	syndip	RF	False	996	46.0	0.9291417469817493	0.9295194070642406	1719	1598	86	35	80759	77203	3244	75813	15568	0.959675314182008	0.5045420086788309	genomes
truth_sample_rank	syndip	RF	False	1000	47.0	0.928807927317579	0.9291417469817493	1718	1594	97	27	82477	78797	3341	74219	15471	0.9593245513647763	0.5149592199508548	genomes
truth_sample_rank	syndip	RF	False	1004	48.0	0.9281267010374931	0.9287881157076475	1718	1567	136	15	84195	80364	3477	72652	15335	0.958528643503775	0.5251999790871543	genomes
truth_sample_rank	syndip	RF	False	1008	49.0	0.9278137800818776	0.9281267010374931	1718	1605	105	8	85913	81969	3582	71047	15230	0.9581302381035873	0.5356890782663251	genomes
truth_sample_rank	syndip	RF	False	1012	50.0	0.9271261507562395	0.9278137800818776	1719	1562	132	25	87632	83531	3714	69485	15098	0.9574302252278067	0.5458971610811941	genomes
truth_sample_rank	syndip	RF	False	1016	51.0	0.9259431842338958	0.9271261507562395	1718	1561	133	24	89350	85092	3847	67924	14965	0.956745634648467	0.556098708631777	genomes
truth_sample_rank	syndip	RF	False	1020	52.0	0.9241230321548357	0.9259431842338958	1718	1538	136	44	91068	86630	3983	66386	14829	0.9560438347698453	0.56614994510378	genomes
truth_sample_rank	syndip	RF	False	1024	53.0	0.9211361167618746	0.9241230321548357	1719	1465	187	67	92787	88095	4170	64921	14642	0.9548040968948138	0.5757241072828985	genomes
truth_sample_rank	syndip	RF	False	1028	54.0	0.9203194071936307	0.9211361167618746	1718	1606	78	34	94505	89701	4248	63315	14564	0.9547839785415492	0.5862197417263554	genomes
truth_sample_rank	syndip	RF	False	1032	55.0	0.9193691003762504	0.9203194071936307	1718	1583	94	41	96223	91284	4342	61732	14470	0.9545939388869136	0.5965650650912323	genomes
truth_sample_rank	syndip	RF	False	1036	56.0	0.9181321427879106	0.9193691003762504	1718	1587	97	34	97941	92871	4439	60145	14373	0.9543829000102765	0.6069365295132535	genomes
truth_sample_rank	syndip	RF	False	1040	57.0	0.9166604170649097	0.9181261669760978	1719	1596	99	24	99660	94467	4538	58549	14274	0.9541639311145902	0.6173668113138495	genomes
truth_sample_rank	syndip	RF	False	1044	58.0	0.9153324501650382	0.9166604170649097	1718	1572	116	30	101378	96039	4654	56977	14158	0.9537803025036498	0.6276402467715795	genomes
truth_sample_rank	syndip	RF	False	1048	59.0	0.911278902326804	0.9153324501650382	1718	1518	149	51	103096	97557	4803	55459	14009	0.9530773739742087	0.6375607779578606	genomes
truth_sample_rank	syndip	RF	False	1052	60.0	0.9095595706912288	0.911278902326804	1719	1587	102	30	104815	99144	4905	53872	13907	0.9528587492431451	0.6479322423798819	genomes
truth_sample_rank	syndip	RF	False	1056	61.0	0.9074331649379862	0.9095595706912288	1718	1529	149	40	106533	100673	5054	52343	13758	0.952197641094517	0.65792466147331	genomes
truth_sample_rank	syndip	RF	False	1060	62.0	0.9035501681577836	0.9074331649379862	1718	1520	169	29	108251	102193	5223	50823	13589	0.9513759588888061	0.6678582631881633	genomes
truth_sample_rank	syndip	RF	False	1064	63.0	0.894932037622703	0.9035501681577836	1718	1515	157	46	109969	103708	5380	49308	13432	0.9506820181871517	0.6777591885815862	genomes
truth_sample_rank	syndip	RF	False	1068	64.0	0.8817148510733903	0.894932037622703	1719	1441	228	50	111688	105149	5608	47867	13204	0.9493666314544453	0.6871765044178386	genomes
truth_sample_rank	syndip	RF	False	1072	65.0	0.8730349462072133	0.8817148510733903	1718	1520	173	25	113406	106669	5781	46347	13031	0.9485904846598489	0.697110106132692	genomes
truth_sample_rank	syndip	RF	False	1076	66.0	0.8595456957601286	0.8730349462072133	1718	1443	207	68	115124	108112	5988	44904	12824	0.9475197195442594	0.7065404924975166	genomes
truth_sample_rank	syndip	RF	False	1080	67.0	0.8453832114726403	0.8595456957601286	1719	1437	215	67	116843	109549	6203	43467	12609	0.9464112931094063	0.7159316672766247	genomes
truth_sample_rank	syndip	RF	False	1084	68.0	0.8429702513696302	0.8453832114726403	1718	1413	274	31	118561	110962	6477	42054	12335	0.9448479636236684	0.7251659957128667	genomes
truth_sample_rank	syndip	RF	False	1088	69.0	0.8359977366045146	0.8429702513696302	1718	1433	227	58	120279	112395	6704	40621	12108	0.9437106944642693	0.7345310294348304	genomes
truth_sample_rank	syndip	RF	False	1092	70.0	0.8309562187478592	0.8359977366045146	1718	1290	311	117	121997	113685	7015	39331	11797	0.941880695940348	0.7429615203638835	genomes
truth_sample_rank	syndip	RF	False	1096	71.0	0.8164756819074619	0.8309562187478592	1719	1257	360	102	123716	114942	7375	38074	11437	0.9397058462846538	0.7511763475714958	genomes
truth_sample_rank	syndip	RF	False	1100	72.0	0.8049943298549254	0.8164756819074619	1718	1222	365	131	125434	116164	7740	36852	11072	0.9375322830578512	0.759162440529095	genomes
truth_sample_rank	syndip	RF	False	1104	73.0	0.782727193279991	0.8049943298549254	1718	1069	394	255	127152	117233	8134	35783	10678	0.9351184921071733	0.7661486380509228	genomes
truth_sample_rank	syndip	RF	False	1108	74.0	0.7671837718906996	0.7827200876219189	1718	1269	315	134	128870	118502	8449	34514	10363	0.9334467629242779	0.7744418884299681	genomes
truth_sample_rank	syndip	RF	False	1112	75.0	0.7627757229264206	0.7671837718906996	1719	1131	503	85	130589	119633	8952	33383	9860	0.9303806820391181	0.7818332723375333	genomes
truth_sample_rank	syndip	RF	False	1116	76.0	0.7498247714069591	0.7627757229264206	1718	1213	353	152	132307	120846	9305	32170	9507	0.9285061198146768	0.7897605479165577	genomes
truth_sample_rank	syndip	RF	False	1120	77.0	0.7417449909966373	0.7498233608177653	1718	1381	213	124	134025	122227	9518	30789	9294	0.9277543739800372	0.7987857478956449	genomes
truth_sample_rank	syndip	RF	False	1124	78.0	0.7324000130007841	0.7417449909966373	1719	1300	322	97	135744	123527	9840	29489	8972	0.9262186297959765	0.807281591467559	genomes
truth_sample_rank	syndip	RF	False	1128	79.0	0.7124898848020704	0.7324000130007841	1718	1081	484	153	137462	124608	10324	28408	8488	0.9234873862389944	0.8143462121608198	genomes
truth_sample_rank	syndip	RF	False	1132	80.0	0.6889497255721624	0.7124750107148685	1718	1155	400	163	139180	125763	10724	27253	8088	0.9214284144277477	0.8218944424112511	genomes
truth_sample_rank	syndip	RF	False	1136	81.0	0.6344869907713666	0.6889495485206737	1718	955	469	294	140898	126718	11193	26298	7619	0.9188389613591375	0.8281356198044649	genomes
truth_sample_rank	syndip	RF	False	1140	82.0	0.6121567682809688	0.6344388985957651	1719	1073	464	182	142617	127791	11657	25225	7155	0.916406115541277	0.835147958383437	genomes
truth_sample_rank	syndip	RF	False	1144	83.0	0.6055386586396949	0.6121567682809688	1718	1390	271	57	144335	129181	11928	23835	6884	0.9154696015137235	0.844231975741099	genomes
truth_sample_rank	syndip	RF	False	1148	84.0	0.5801111588554961	0.6055386586396949	1718	946	509	263	146053	130127	12437	22889	6375	0.9127619875985522	0.850414335755738	genomes
truth_sample_rank	syndip	RF	False	1152	85.0	0.5066920975908127	0.5799634066182894	1719	874	521	324	147772	131001	12958	22015	5854	0.9099882605464056	0.8561261567417786	genomes
truth_sample_rank	syndip	RF	False	1156	86.0	0.3302463076427135	0.5066920975908127	1718	600	616	502	149490	131601	13574	21415	5238	0.9064990528672292	0.8600473153134313	genomes
truth_sample_rank	syndip	RF	False	1160	87.0	0.1429618450360884	0.3301285116123204	1718	486	543	689	151208	132087	14117	20929	4695	0.9034431342507729	0.8632234537564699	genomes
truth_sample_rank	syndip	RF	False	1164	88.0	0.043973128156171506	0.14288473984631064	1718	328	884	506	152926	132415	15001	20601	3811	0.898240353828621	0.8653670204423067	genomes
truth_sample_rank	syndip	RF	False	1168	89.0	0.009776439754704507	0.043962548821200646	1719	20	1612	87	154645	132435	16613	20581	2199	0.8885392625194568	0.8654977257280284	genomes
truth_sample_rank	syndip	RF	False	1172	90.0	0.0031526425952785033	0.009776336208508584	1718	0	1710	8	156363	132435	18323	20581	489	0.8784608445322968	0.8654977257280284	genomes
truth_sample_rank	syndip	RF	False	1176	91.0	0.0014916482210623925	0.003149409489354318	1718	26	364	1328	158081	132461	18687	20555	125	0.8763662106015296	0.8656676425994667	genomes
truth_sample_rank	syndip	RF	False	1180	92.0	-1.0	-1.0	1719	30	13	1676	159800	132491	18700	20525	112	0.8763153891435337	0.8658637005280494	genomes
truth_sample_rank	syndip	RF	False	1184	93.0	-1.0	-1.0	1718	35	17	1666	161518	132526	18717	20490	95	0.8762455121889938	0.8660924347780624	genomes
truth_sample_rank	syndip	RF	False	1188	94.0	-1.0	-1.0	1718	25	22	1671	163236	132551	18739	20465	73	0.8761385418732236	0.8662558163852146	genomes
truth_sample_rank	syndip	RF	False	1192	95.0	-1.0	-1.0	1718	35	12	1671	164954	132586	18751	20430	61	0.8760977156941131	0.8664845506352277	genomes
truth_sample_rank	syndip	RF	False	1196	96.0	-1.0	-1.0	1719	36	15	1668	166673	132622	18766	20394	46	0.8760403730810896	0.8667198201495269	genomes
truth_sample_rank	syndip	RF	False	1200	97.0	-1.0	-1.0	1718	36	22	1660	168391	132658	18788	20358	24	0.8759425801936004	0.866955089663826	genomes
truth_sample_rank	syndip	RF	False	1204	98.0	-1.0	-1.0	1718	35	11	1672	170109	132693	18799	20323	13	0.8759076386871913	0.8671838239138391	genomes
truth_sample_rank	syndip	RF	False	1208	99.0	-1.0	-1.0	1718	32	13	1673	171827	132725	18812	20291	0	0.8758587011752905	0.8673929523709939	genomes
truth_sample_rank	syndip	RF	False	1212	100.0	-1.0	-1.0	1	0	0	1	171828	132725	18812	20291	0	0.8758587011752905	0.8673929523709939	genomes
truth_sample_rank	syndip	RF	True	1216	0.0	0.9719609898644941	0.9719609898644941	33616	33608	6	2	33616	33608	6	3268107	59887	0.9998215029452014	0.010178952453497652	genomes
truth_sample_rank	syndip	RF	True	1220	1.0	0.9719609898644941	0.9719609898644941	33616	33602	13	1	67232	67210	19	3234505	59874	0.9997173838670812	0.020356087669589896	genomes
truth_sample_rank	syndip	RF	True	1224	2.0	0.9719609898644941	0.9719609898644941	33616	33605	8	3	100848	100815	27	3200900	59866	0.9997322544178021	0.030534131504384842	genomes
truth_sample_rank	syndip	RF	True	1228	3.0	0.9719609898644941	0.9719609898644941	33616	33605	9	2	134464	134420	36	3167295	59857	0.9997322544178021	0.04071217533917979	genomes
truth_sample_rank	syndip	RF	True	1232	4.0	0.9719609898644941	0.9719609898644941	33616	33607	8	1	168080	168027	44	3133688	59849	0.999738205877278	0.05089082491977654	genomes
truth_sample_rank	syndip	RF	True	1236	5.0	0.9719609898644941	0.9719609898644941	33616	33603	11	2	201696	201630	55	3100085	59838	0.9997272975184074	0.061068263008769684	genomes
truth_sample_rank	syndip	RF	True	1240	6.0	0.9719609898644941	0.9719609898644941	33616	33610	5	1	235312	235240	60	3066475	59833	0.9997450063748407	0.07124782120806913	genomes
truth_sample_rank	syndip	RF	True	1244	7.0	0.9719609898644941	0.9719609898644941	33616	33607	5	4	268928	268847	65	3032868	59828	0.9997582852382936	0.08142647078866588	genomes
truth_sample_rank	syndip	RF	True	1248	8.0	0.9719609898644941	0.9719609898644941	33616	33606	8	2	302544	302453	73	2999262	59820	0.9997586984259205	0.09160481749636173	genomes
truth_sample_rank	syndip	RF	True	1252	9.0	0.9719609898644941	0.9719609898644941	33616	33613	2	1	336160	336066	75	2965649	59818	0.9997768793452747	0.1017852843143639	genomes
truth_sample_rank	syndip	RF	True	1256	10.0	0.9719609898644941	0.9719609898644941	33616	33614	1	1	369776	369680	76	2932035	59817	0.9997944590486699	0.11196605400526696	genomes
truth_sample_rank	syndip	RF	True	1260	11.0	0.9719609898644941	0.9719609898644941	33616	33612	2	2	403392	403292	78	2898423	59815	0.9998066291494162	0.12214621795036822	genomes
truth_sample_rank	syndip	RF	True	1264	12.0	0.9719609898644941	0.9719609898644941	33616	33600	11	5	437008	436892	89	2864823	59804	0.9997963298175435	0.13232274742065867	genomes
truth_sample_rank	syndip	RF	True	1268	13.0	0.9719609898644941	0.9719609898644941	33617	33612	4	1	470625	470504	93	2831211	59800	0.9998023786806971	0.1425029113657599	genomes
truth_sample_rank	syndip	RF	True	1272	14.0	0.9719609898644941	0.9719609898644941	33616	33608	2	6	504241	504112	95	2797603	59798	0.9998115853211081	0.15268186381925758	genomes
truth_sample_rank	syndip	RF	True	1276	15.0	0.9719609898644941	0.9719609898644941	33616	33611	3	2	537857	537723	98	2763992	59795	0.9998177832401487	0.16286172489145792	genomes
truth_sample_rank	syndip	RF	True	1280	16.0	0.9719609898644941	0.9719609898644941	33616	33604	10	2	571473	571327	108	2730388	59785	0.9998110021262261	0.17303946585335198	genomes
truth_sample_rank	syndip	RF	True	1284	17.0	0.9719609898644941	0.9719609898644941	33616	33604	7	5	605089	604931	115	2696784	59778	0.9998099318068379	0.183217206815246	genomes
truth_sample_rank	syndip	RF	True	1288	18.0	0.9719609898644941	0.9719609898644941	33616	33605	10	1	638705	638536	125	2663179	59768	0.9998042780129052	0.19339525065004096	genomes
truth_sample_rank	syndip	RF	True	1292	19.0	0.9719609898644941	0.9719609898644941	33616	33607	6	3	672321	672143	131	2629572	59762	0.9998051389760723	0.2035739002306377	genomes
truth_sample_rank	syndip	RF	True	1296	20.0	0.9719609898644941	0.9719609898644941	33616	33606	6	4	705937	705749	137	2595966	59756	0.9998059176694254	0.21375224693833356	genomes
truth_sample_rank	syndip	RF	True	1300	21.0	0.9719609898644941	0.9719609898644941	33616	33612	3	1	739553	739361	140	2562354	59753	0.9998106831498538	0.22393241088343482	genomes
truth_sample_rank	syndip	RF	True	1304	22.0	0.9719609898644941	0.9719609898644941	33616	33607	6	3	773169	772968	146	2528747	59747	0.9998111533357306	0.23411106046403157	genomes
truth_sample_rank	syndip	RF	True	1308	23.0	0.9719609898644941	0.9719609898644941	33616	33606	8	2	806785	806574	154	2495141	59739	0.9998091054233893	0.24428940717172742	genomes
truth_sample_rank	syndip	RF	True	1312	24.0	0.9719609898644941	0.9719609898644941	33616	33606	9	1	840401	840180	163	2461535	59730	0.9998060315847219	0.2544677538794233	genomes
truth_sample_rank	syndip	RF	True	1316	25.0	0.9719609898644941	0.9719609898644941	33616	33608	6	2	874017	873788	169	2427927	59724	0.9998066266418142	0.2646467063329209	genomes
truth_sample_rank	syndip	RF	True	1320	26.0	0.9719609898644941	0.9719609898644941	33617	33606	8	3	907634	907394	177	2394321	59716	0.9998049739359235	0.2748250530406168	genomes
truth_sample_rank	syndip	RF	True	1324	27.0	0.9719609898644941	0.9719609898644941	33616	33608	6	2	941250	941002	183	2360713	59710	0.9998055642620739	0.2850040054941144	genomes
truth_sample_rank	syndip	RF	True	1328	28.0	0.9719609898644941	0.9719609898644941	33616	33603	10	3	974866	974605	193	2327110	59700	0.999802010262639	0.29518144358310755	genomes
truth_sample_rank	syndip	RF	True	1332	29.0	0.9719609898644941	0.9719609898644941	33616	33596	18	2	1008482	1008201	211	2293514	59682	0.9997907601258216	0.3053567615617944	genomes
truth_sample_rank	syndip	RF	True	1336	30.0	0.9719609898644941	0.9719609898644941	33616	33609	5	2	1042098	1041810	216	2259905	59677	0.9997927115062388	0.31553601688819294	genomes
truth_sample_rank	syndip	RF	True	1340	31.0	0.9719609898644941	0.9719609898644941	33616	33603	9	4	1075714	1075413	225	2226302	59668	0.9997908218192366	0.3257134549771861	genomes
truth_sample_rank	syndip	RF	True	1344	32.0	0.9719609898644941	0.9719609898644941	33616	33610	5	1	1109330	1109023	230	2192692	59663	0.9997926532540368	0.33589301317648557	genomes
truth_sample_rank	syndip	RF	True	1348	33.0	0.9719609898644941	0.9719609898644941	33616	33609	6	1	1142946	1142632	236	2159083	59657	0.9997935019617313	0.3460722685028841	genomes
truth_sample_rank	syndip	RF	True	1352	34.0	0.9719609898644941	0.9719609898644941	33616	33608	6	2	1176562	1176240	242	2125475	59651	0.9997943019952706	0.3562512209563818	genomes
truth_sample_rank	syndip	RF	True	1356	35.0	0.9719609898644941	0.9719609898644941	33616	33610	3	3	1210178	1209850	245	2091865	59648	0.9997975365570472	0.36643077915568123	genomes
truth_sample_rank	syndip	RF	True	1360	36.0	0.9719609898644941	0.9719609898644941	33616	33608	7	1	1243794	1243458	252	2058257	59641	0.9997973804182647	0.3766097316091789	genomes
truth_sample_rank	syndip	RF	True	1364	37.0	0.9719609898644941	0.9719609898644941	33616	33606	7	3	1277410	1277064	259	2024651	59634	0.9997972321801142	0.38678807831687473	genomes
truth_sample_rank	syndip	RF	True	1368	38.0	0.9719609898644941	0.9719609898644941	33617	33594	20	3	1311027	1310658	279	1991057	59614	0.9997871751274089	0.39696279054975975	genomes
truth_sample_rank	syndip	RF	True	1372	39.0	0.9719609898644941	0.9719609898644941	33616	33607	7	2	1344643	1344265	286	1957450	59607	0.9997872895858915	0.40714144013035647	genomes
truth_sample_rank	syndip	RF	True	1376	40.0	0.9719609898644941	0.9719609898644941	33616	33612	3	1	1378259	1377877	289	1923838	59604	0.999790301023244	0.41732160407545776	genomes
truth_sample_rank	syndip	RF	True	1380	41.0	0.9719609898644941	0.9719609898644941	33616	33607	8	1	1411875	1411484	297	1890231	59596	0.9997896274280501	0.4275002536560545	genomes
truth_sample_rank	syndip	RF	True	1384	42.0	0.9719609898644941	0.9719609898644941	33616	33609	7	0	1445491	1445093	304	1856622	59589	0.9997896771613612	0.43767950898245306	genomes
truth_sample_rank	syndip	RF	True	1388	43.0	0.9719609898644941	0.9719609898644941	33616	33615	1	0	1479107	1478708	305	1823007	59588	0.9997937813934022	0.447860581546257	genomes
truth_sample_rank	syndip	RF	True	1392	44.0	0.9719609898644941	0.9719609898644941	33616	33608	8	0	1512723	1512316	313	1789399	59580	0.9997930754996764	0.45803953399975467	genomes
truth_sample_rank	syndip	RF	True	1396	45.0	0.9719609898644941	0.9719609898644941	33616	33609	6	1	1546339	1545925	319	1755790	59574	0.9997936936214465	0.46821878932615324	genomes
truth_sample_rank	syndip	RF	True	1400	46.0	0.9719609898644941	0.9719609898644941	33616	33601	9	6	1579955	1579526	328	1722189	59565	0.9997923858786951	0.4783956216693446	genomes
truth_sample_rank	syndip	RF	True	1404	47.0	0.9719609898644941	0.9719609898644941	33616	33602	8	6	1613571	1613128	336	1688587	59557	0.9997917524035244	0.48857275688543683	genomes
truth_sample_rank	syndip	RF	True	1408	48.0	0.9719609898644941	0.9719609898644941	33616	33599	10	7	1647187	1646727	346	1654988	59547	0.9997899303795278	0.49874898348282637	genomes
truth_sample_rank	syndip	RF	True	1412	49.0	0.9719609898644941	0.9719609898644941	33616	33608	5	3	1680803	1680335	351	1621380	59542	0.9997911567062497	0.508927935936324	genomes
truth_sample_rank	syndip	RF	True	1416	50.0	0.9719609898644941	0.9719609898644941	33616	33610	2	4	1714419	1713945	353	1587770	59540	0.9997940848090588	0.5191074941356234	genomes
truth_sample_rank	syndip	RF	True	1420	51.0	0.9716534902506142	0.9719609898644941	33616	33548	25	43	1748035	1747493	378	1554222	59515	0.999783736900492	0.5292682742150671	genomes
truth_sample_rank	syndip	RF	True	1424	52.0	0.9715833297820027	0.9716534902506142	33617	33586	20	11	1781652	1781079	398	1520636	59495	0.9997765898745816	0.5394405634647448	genomes
truth_sample_rank	syndip	RF	True	1428	53.0	0.9715833297820027	0.9715833297820027	33616	33583	31	2	1815268	1814662	429	1487053	59464	0.999763648213781	0.54961194409572	genomes
truth_sample_rank	syndip	RF	True	1432	54.0	0.9715833297820027	0.9715833297820027	33616	33604	6	6	1848884	1848266	435	1453449	59458	0.9997646996458595	0.559789685057614	genomes
truth_sample_rank	syndip	RF	True	1436	55.0	0.9715833297820027	0.9715833297820027	33616	33604	9	3	1882500	1881870	444	1419845	59449	0.999764120120235	0.569967426019508	genomes
truth_sample_rank	syndip	RF	True	1440	56.0	0.9715833297820027	0.9715833297820027	33616	33589	23	4	1916116	1915459	467	1386256	59426	0.999756253634013	0.5801406238878886	genomes
truth_sample_rank	syndip	RF	True	1444	57.0	0.9715833297820027	0.9715833297820027	33616	33600	14	2	1949732	1949059	481	1352656	59412	0.9997532751315695	0.590317153358179	genomes
truth_sample_rank	syndip	RF	True	1448	58.0	0.9715833297820027	0.9715833297820027	33616	33600	12	4	1983348	1982659	493	1319056	59400	0.99975140584282	0.6004936828284695	genomes
truth_sample_rank	syndip	RF	True	1452	59.0	0.9715833297820027	0.9715833297820027	33616	33604	8	4	2016964	2016263	501	1285452	59392	0.9997515822376838	0.6106714237903635	genomes
truth_sample_rank	syndip	RF	True	1456	60.0	0.9715833297820027	0.9715833297820027	33616	33600	9	7	2050580	2049863	510	1251852	59383	0.9997512647698735	0.6208479532606539	genomes
truth_sample_rank	syndip	RF	True	1460	61.0	0.9715833297820027	0.9715833297820027	33616	33596	18	2	2084196	2083459	528	1218256	59365	0.9997466394943922	0.6310232712393408	genomes
truth_sample_rank	syndip	RF	True	1464	62.0	0.9715833297820027	0.9715833297820027	33616	33601	13	2	2117812	2117060	541	1184655	59352	0.9997445222211361	0.6412001035825321	genomes
truth_sample_rank	syndip	RF	True	1468	63.0	0.9715833297820027	0.9715833297820027	33616	33598	15	3	2151428	2150658	556	1151057	59337	0.9997415412878495	0.6513760273070207	genomes
truth_sample_rank	syndip	RF	True	1472	64.0	0.9715833297820027	0.9715833297820027	33617	33601	12	4	2185045	2184259	568	1117456	59325	0.9997400251827719	0.661552859650212	genomes
truth_sample_rank	syndip	RF	True	1476	65.0	0.9715833297820027	0.9715833297820027	33616	33599	12	5	2218661	2217858	580	1083857	59313	0.9997385547849433	0.6717290862476016	genomes
truth_sample_rank	syndip	RF	True	1480	66.0	0.9715833297820027	0.9715833297820027	33616	33605	11	0	2252277	2251463	591	1050252	59302	0.999737572900117	0.6819071300823966	genomes
truth_sample_rank	syndip	RF	True	1484	67.0	0.9715833297820027	0.9715833297820027	33616	33602	13	1	2285893	2285065	604	1016650	59289	0.9997357447644432	0.6920842652984888	genomes
truth_sample_rank	syndip	RF	True	1488	68.0	0.9715833297820027	0.9715833297820027	33616	33604	10	2	2319509	2318669	614	983046	59279	0.999735263010163	0.7022620062603828	genomes
truth_sample_rank	syndip	RF	True	1492	69.0	0.9715833297820027	0.9715833297820027	33616	33597	16	3	2353125	2352266	630	949449	59263	0.9997322448591013	0.7124376271119706	genomes
truth_sample_rank	syndip	RF	True	1496	70.0	0.9715833297820027	0.9715833297820027	33616	33598	16	2	2386741	2385864	646	915851	59247	0.9997293118403023	0.7226135508364593	genomes
truth_sample_rank	syndip	RF	True	1500	71.0	0.9715833297820027	0.9715833297820027	33616	33599	14	3	2420357	2419463	660	882252	59233	0.9997272865883263	0.7327897774338488	genomes
truth_sample_rank	syndip	RF	True	1504	72.0	0.9715833297820027	0.9715833297820027	33616	33598	13	5	2453973	2453061	673	848654	59220	0.9997257241412476	0.7429657011583374	genomes
truth_sample_rank	syndip	RF	True	1508	73.0	0.9709104254706233	0.9715833297820027	33616	33577	26	13	2487589	2486638	699	815077	59194	0.999718976560072	0.7531352645519072	genomes
truth_sample_rank	syndip	RF	True	1512	74.0	0.9709104254706233	0.9709104254706233	33616	33603	10	3	2521205	2520241	709	781474	59184	0.9997187568178663	0.7633127026409002	genomes
truth_sample_rank	syndip	RF	True	1516	75.0	0.9709104254706233	0.9709104254706233	33616	33605	6	5	2554821	2553846	715	747869	59178	0.9997201084648204	0.7734907464756952	genomes
truth_sample_rank	syndip	RF	True	1520	76.0	0.9709104254706233	0.9709104254706233	33616	33608	5	3	2588437	2587454	720	714261	59173	0.9997218115938109	0.7836696989291928	genomes
truth_sample_rank	syndip	RF	True	1524	77.0	0.9707170463107051	0.9709104254706233	33617	33606	8	3	2622054	2621060	728	680655	59165	0.9997223269005732	0.7938480456368887	genomes
truth_sample_rank	syndip	RF	True	1528	78.0	0.9707170463107051	0.9707170463107051	33616	33604	10	2	2655670	2654664	738	647051	59155	0.9997220759794562	0.8040257865987828	genomes
truth_sample_rank	syndip	RF	True	1532	79.0	0.9707170463107051	0.9707170463107051	33616	33601	12	3	2689286	2688265	750	613450	59143	0.9997210874613939	0.8142026189419741	genomes
truth_sample_rank	syndip	RF	True	1536	80.0	0.9707170463107051	0.9707170463107051	33616	33594	18	4	2722902	2721859	768	579856	59125	0.9997179194946645	0.8243773311748591	genomes
truth_sample_rank	syndip	RF	True	1540	81.0	0.9705327653881318	0.9707170463107051	33616	33579	24	13	2756518	2755438	792	546277	59101	0.9997126509761523	0.8345475003142306	genomes
truth_sample_rank	syndip	RF	True	1544	82.0	0.9705327653881318	0.9705327653881318	33616	33584	24	8	2790134	2789022	816	512693	59077	0.9997075098984242	0.8447191838181066	genomes
truth_sample_rank	syndip	RF	True	1548	83.0	0.9703393862282137	0.9705327653881318	33616	33580	30	6	2823750	2822602	846	479113	59047	0.9997003663605634	0.854889655830379	genomes
truth_sample_rank	syndip	RF	True	1552	84.0	0.9696664819168342	0.9703393862282137	33616	33580	25	11	2857366	2856182	871	445533	59022	0.999695140412166	0.8650601278426515	genomes
truth_sample_rank	syndip	RF	True	1556	85.0	0.9666507171598319	0.9696664819168342	33616	33547	35	34	2890982	2889729	906	411986	58987	0.9996865740572574	0.8752206050491941	genomes
truth_sample_rank	syndip	RF	True	1560	86.0	0.965406773606043	0.9666507171598319	33616	33502	44	70	2924598	2923231	950	378484	58943	0.9996751227095724	0.8853674529751963	genomes
truth_sample_rank	syndip	RF	True	1564	87.0	0.9618182896618064	0.965406773606043	33616	33448	72	96	2958214	2956679	1022	345036	58871	0.9996544613535986	0.8954979457645497	genomes
truth_sample_rank	syndip	RF	True	1568	88.0	0.9430274301180078	0.9618182896618064	33616	33252	207	157	2991830	2989931	1229	311784	58664	0.9995891226146378	0.9055690754653264	genomes
truth_sample_rank	syndip	RF	True	1572	89.0	0.9329067672380342	0.9430274301180078	33617	33219	162	236	3025447	3023150	1391	278565	58502	0.9995400955054007	0.9156302103603733	genomes
truth_sample_rank	syndip	RF	True	1576	90.0	0.88443749017005	0.9329067672380342	33616	32897	327	392	3059063	3056047	1718	245668	58175	0.9994381517219276	0.92559382018133	genomes
truth_sample_rank	syndip	RF	True	1580	91.0	0.8537282943557526	0.88443749017005	33616	33156	106	354	3092679	3089203	1824	212512	58069	0.999409904863335	0.9356358740836201	genomes
truth_sample_rank	syndip	RF	True	1584	92.0	0.8486071070630382	0.8537282943557526	33616	33291	81	244	3126295	3122494	1905	179221	57988	0.9993902827391764	0.945718815827532	genomes
truth_sample_rank	syndip	RF	True	1588	93.0	0.8463333286131032	0.8486071070630382	33616	33178	184	254	3159911	3155672	2089	146043	57804	0.999338455316916	0.955767532933642	genomes
truth_sample_rank	syndip	RF	True	1592	94.0	0.8176394432430779	0.8463333286131032	33616	32555	300	761	3193527	3188227	2389	113488	57504	0.9992512417664802	0.9656275602224904	genomes
truth_sample_rank	syndip	RF	True	1596	95.0	0.6484057649335048	0.8176394432430779	33616	29713	1079	2824	3227143	3217940	3468	83775	56425	0.9989234521054148	0.9746268227269768	genomes
truth_sample_rank	syndip	RF	True	1600	96.0	0.4786069352949573	0.6484026380759632	33616	28417	2964	2235	3260759	3246357	6432	55358	53461	0.9980226199731984	0.9832335619518947	genomes
truth_sample_rank	syndip	RF	True	1604	97.0	0.07541607674462826	0.47857122425444304	33616	18209	8657	6750	3294375	3264566	15089	37149	44804	0.9953992111975193	0.9887485746044101	genomes
truth_sample_rank	syndip	RF	True	1608	98.0	0.003501037241171516	0.07540963200407332	33616	1209	30896	1511	3327991	3265775	45985	35940	13908	0.9861146339106699	0.9891147479416	genomes
truth_sample_rank	syndip	RF	True	1612	99.0	0.0014067156666908416	0.003501037241171516	33616	11206	13908	8502	3361607	3276981	59893	24734	0	0.982051165252269	0.9925087416691023	genomes
truth_sample_rank	syndip	RF	True	1616	100.0	-1.0	-1.0	1	1	0	0	3361608	3276982	59893	24733	0	0.9820511706312044	0.9925090445420032	genomes
truth_sample_rank	syndip	VQSR	False	813	0.0	7.94	93.56	1718	1653	59	6	1718	1653	59	151363	18753	0.9655373831775701	0.010802791864903016	genomes
truth_sample_rank	syndip	VQSR	False	817	1.0	7.86	7.94	1718	1697	17	4	3436	3350	76	149666	18736	0.9778166958552248	0.021893135358393892	genomes
truth_sample_rank	syndip	VQSR	False	821	2.0	7.8	7.86	1718	1700	17	1	5154	5050	93	147966	18719	0.9819171689675287	0.03300308464474303	genomes
truth_sample_rank	syndip	VQSR	False	825	3.0	7.75	7.8	1719	1692	27	0	6873	6742	120	146274	18692	0.9825123870591664	0.044060751816803474	genomes
truth_sample_rank	syndip	VQSR	False	829	4.0	7.71	7.75	1718	1696	19	3	8591	8438	139	144578	18673	0.9837938673195756	0.05514456004600826	genomes
truth_sample_rank	syndip	VQSR	False	833	5.0	7.67	7.71	1718	1700	16	2	10309	10138	155	142878	18657	0.9849412221898377	0.0662545093323574	genomes
truth_sample_rank	syndip	VQSR	False	837	6.0	7.63	7.67	1718	1695	19	4	12027	11833	174	141183	18638	0.9855084534021821	0.07733178229727611	genomes
truth_sample_rank	syndip	VQSR	False	841	7.0	7.6	7.63	1719	1693	23	3	13746	13526	197	139490	18615	0.9856445383662464	0.08839598473362263	genomes
truth_sample_rank	syndip	VQSR	False	845	8.0	7.56	7.6	1718	1697	20	1	15464	15223	217	137793	18595	0.9859455958549223	0.09948632822711351	genomes
truth_sample_rank	syndip	VQSR	False	849	9.0	7.53	7.56	1718	1701	13	4	17182	16924	230	136092	18582	0.9865920485018072	0.11060281277774874	genomes
truth_sample_rank	syndip	VQSR	False	853	10.0	7.5	7.53	1719	1698	16	5	18901	18622	246	134394	18566	0.9869620521517914	0.12169969153552569	genomes
truth_sample_rank	syndip	VQSR	False	857	11.0	7.47	7.5	1718	1698	17	3	20619	20320	263	132696	18549	0.9872224651411359	0.13279657029330266	genomes
truth_sample_rank	syndip	VQSR	False	861	12.0	7.44	7.47	1718	1698	18	2	22337	22018	281	130998	18531	0.9873985380510337	0.14389344905107962	genomes
truth_sample_rank	syndip	VQSR	False	865	13.0	7.42	7.44	1718	1693	24	1	24055	23711	305	129305	18507	0.9873001332445037	0.15495765148742616	genomes
truth_sample_rank	syndip	VQSR	False	869	14.0	7.39	7.42	1719	1703	14	2	25774	25414	319	127602	18493	0.9876034663661446	0.16608720656663356	genomes
truth_sample_rank	syndip	VQSR	False	873	15.0	7.36	7.39	1718	1699	18	1	27492	27113	337	125903	18475	0.9877231329690346	0.1771906205886966	genomes
truth_sample_rank	syndip	VQSR	False	877	16.0	7.33	7.36	1718	1694	23	1	29210	28807	360	124209	18452	0.9876572839167552	0.18826135828932922	genomes
truth_sample_rank	syndip	VQSR	False	881	17.0	7.3	7.33	1719	1697	21	1	30929	30504	381	122512	18431	0.9876639145216124	0.1993517017828201	genomes
truth_sample_rank	syndip	VQSR	False	885	18.0	7.26	7.3	1718	1704	12	2	32647	32208	393	120808	18419	0.9879451550565933	0.21048779212631358	genomes
truth_sample_rank	syndip	VQSR	False	889	19.0	7.23	7.26	1718	1693	24	1	34365	33901	417	119115	18395	0.9878489422460517	0.22155199456266012	genomes
truth_sample_rank	syndip	VQSR	False	893	20.0	7.2	7.23	1718	1698	18	2	36083	35599	435	117417	18377	0.9879280679358384	0.23264887332043707	genomes
truth_sample_rank	syndip	VQSR	False	897	21.0	7.16	7.2	1719	1698	19	2	37802	37297	454	115719	18358	0.9879738285078541	0.24374575207821406	genomes
truth_sample_rank	syndip	VQSR	False	901	22.0	7.12	7.16	1718	1688	25	5	39520	38985	479	114031	18333	0.9878623555645651	0.2547772781931301	genomes
truth_sample_rank	syndip	VQSR	False	905	23.0	7.08	7.12	1718	1697	18	3	41238	40682	497	112334	18315	0.9879307413973142	0.265867621686621	genomes
truth_sample_rank	syndip	VQSR	False	909	24.0	7.04	7.08	1718	1695	18	5	42956	42377	515	110639	18297	0.9879930989461905	0.2769448946515397	genomes
truth_sample_rank	syndip	VQSR	False	913	25.0	7.0	7.04	1719	1694	22	3	44675	44071	537	108945	18275	0.987961800573888	0.2880156323521723	genomes
truth_sample_rank	syndip	VQSR	False	917	26.0	6.95	7.0	1718	1692	20	6	46393	45763	557	107253	18255	0.9879749568221071	0.2990732995242328	genomes
truth_sample_rank	syndip	VQSR	False	921	27.0	6.89	6.95	1718	1689	21	8	48111	47452	578	105564	18234	0.987965854674162	0.31011136090343494	genomes
truth_sample_rank	syndip	VQSR	False	925	28.0	6.84	6.89	1719	1693	21	5	49830	49145	599	103871	18213	0.9879583467352847	0.3211755633397815	genomes
truth_sample_rank	syndip	VQSR	False	929	29.0	6.77	6.84	1718	1689	25	4	51548	50834	624	102182	18188	0.9878736056589841	0.33221362471898364	genomes
truth_sample_rank	syndip	VQSR	False	933	30.0	6.7	6.77	1718	1681	33	4	53266	52515	657	100501	18155	0.9876438727149628	0.3431994039838971	genomes
truth_sample_rank	syndip	VQSR	False	937	31.0	6.63	6.7	1718	1674	41	3	54984	54189	698	98827	18114	0.9872829631788949	0.35413943639880796	genomes
truth_sample_rank	syndip	VQSR	False	941	32.0	6.55	6.63	1719	1660	49	10	56703	55849	747	97167	18065	0.9868011873630645	0.3649879751137136	genomes
truth_sample_rank	syndip	VQSR	False	945	33.0	6.47	6.55	1718	1660	53	5	58421	57509	800	95507	18012	0.9862799910819942	0.3758365138286192	genomes
truth_sample_rank	syndip	VQSR	False	949	34.0	6.39	6.47	1718	1627	86	5	60139	59136	886	93880	17926	0.9852387457932091	0.386469388822084	genomes
truth_sample_rank	syndip	VQSR	False	953	35.0	6.32	6.39	1719	1620	89	10	61858	60756	975	92260	17837	0.9842056665208728	0.3970565169655461	genomes
truth_sample_rank	syndip	VQSR	False	957	36.0	6.25	6.32	1718	1593	113	12	63576	62349	1088	90667	17724	0.9828491259044406	0.4074671929732838	genomes
truth_sample_rank	syndip	VQSR	False	961	37.0	6.17	6.25	1718	1584	121	13	65294	63933	1209	89083	17603	0.9814405452703325	0.4178190516024468	genomes
truth_sample_rank	syndip	VQSR	False	965	38.0	6.11	6.17	1718	1581	127	10	67012	65514	1336	87502	17476	0.9800149588631264	0.4281513044387515	genomes
truth_sample_rank	syndip	VQSR	False	969	39.0	6.04	6.11	1719	1566	142	11	68731	67080	1478	85936	17334	0.9784416114822486	0.4383855283107649	genomes
truth_sample_rank	syndip	VQSR	False	973	40.0	5.97	6.04	1718	1547	156	15	70449	68627	1634	84389	17178	0.9767438550547245	0.4484955821613426	genomes
truth_sample_rank	syndip	VQSR	False	977	41.0	5.91	5.97	1718	1545	156	17	72167	70172	1790	82844	17022	0.9751257608182096	0.45859256548334815	genomes
truth_sample_rank	syndip	VQSR	False	981	42.0	5.84	5.91	1719	1559	146	14	73886	71731	1936	81285	16876	0.9737195759295206	0.4687810425053589	genomes
truth_sample_rank	syndip	VQSR	False	985	43.0	5.77	5.84	1718	1537	169	12	75604	73268	2105	79748	16707	0.9720722274554549	0.47882574371307574	genomes
truth_sample_rank	syndip	VQSR	False	989	44.0	5.7	5.77	1718	1559	150	9	77322	74827	2255	78189	16557	0.9707454399211229	0.48901422073508655	genomes
truth_sample_rank	syndip	VQSR	False	993	45.0	5.62	5.7	1718	1540	170	8	79040	76367	2425	76649	16387	0.9692227637323586	0.49907852773566164	genomes
truth_sample_rank	syndip	VQSR	False	997	46.0	5.54	5.62	1719	1533	176	10	80759	77900	2601	75116	16211	0.9676898423622067	0.5090970878862341	genomes
truth_sample_rank	syndip	VQSR	False	1001	47.0	5.46	5.54	1718	1523	179	16	82477	79423	2780	73593	16032	0.9661812829215479	0.5190502953939458	genomes
truth_sample_rank	syndip	VQSR	False	1005	48.0	5.37	5.46	1718	1512	193	13	84195	80935	2973	72081	15839	0.9645683367497736	0.5289316149945104	genomes
truth_sample_rank	syndip	VQSR	False	1009	49.0	5.26	5.36	1718	1532	167	19	85913	82467	3140	70549	15672	0.9633207564801943	0.5389436398807967	genomes
truth_sample_rank	syndip	VQSR	False	1013	50.0	5.15	5.26	1719	1499	202	18	87632	83966	3342	69050	15470	0.9617217208045081	0.5487400010456422	genomes
truth_sample_rank	syndip	VQSR	False	1017	51.0	5.03	5.15	1718	1502	188	28	89350	85468	3530	67548	15282	0.9603361873300523	0.5585559680033461	genomes
truth_sample_rank	syndip	VQSR	False	1021	52.0	4.9	5.03	1718	1517	174	27	91068	86985	3704	66031	15108	0.9591571193860335	0.5684699639253411	genomes
truth_sample_rank	syndip	VQSR	False	1025	53.0	4.76	4.9	1719	1537	160	22	92787	88522	3864	64494	14948	0.958175481133505	0.5785146651330579	genomes
truth_sample_rank	syndip	VQSR	False	1029	54.0	4.61	4.76	1718	1521	170	27	94505	90043	4034	62973	14778	0.9571202312998927	0.5884548021121975	genomes
truth_sample_rank	syndip	VQSR	False	1033	55.0	4.45	4.61	1718	1510	171	37	96223	91553	4205	61463	14607	0.9560872198667474	0.5983230511841899	genomes
truth_sample_rank	syndip	VQSR	False	1037	56.0	4.26	4.45	1718	1518	174	26	97941	93071	4379	59945	14433	0.955064135454079	0.608243582370471	genomes
truth_sample_rank	syndip	VQSR	False	1041	57.0	4.06	4.26	1719	1521	164	34	99660	94592	4543	58424	14269	0.9541736016543098	0.6181837193496105	genomes
truth_sample_rank	syndip	VQSR	False	1045	58.0	3.85	4.06	1718	1521	162	35	101378	96113	4705	56903	14107	0.9533317463151422	0.6281238563287499	genomes
truth_sample_rank	syndip	VQSR	False	1049	59.0	3.64	3.85	1718	1524	161	33	103096	97637	4866	55379	13946	0.9525282186862823	0.6380835991007476	genomes
truth_sample_rank	syndip	VQSR	False	1053	60.0	3.46	3.64	1719	1540	144	35	104815	99177	5010	53839	13802	0.9519133865069539	0.6481479061013228	genomes
truth_sample_rank	syndip	VQSR	False	1057	61.0	3.31	3.46	1718	1534	147	37	106533	100711	5157	52305	13655	0.951288396871576	0.6581730015161813	genomes
truth_sample_rank	syndip	VQSR	False	1061	62.0	3.17	3.31	1718	1531	150	37	108251	102242	5307	50774	13505	0.9506550502561623	0.6681784911381816	genomes
truth_sample_rank	syndip	VQSR	False	1065	63.0	3.04	3.17	1718	1507	174	37	109969	103749	5481	49267	13331	0.9498214776160395	0.6780271344173159	genomes
truth_sample_rank	syndip	VQSR	False	1069	64.0	2.89	3.04	1719	1500	173	46	111688	105249	5654	47767	13158	0.9490185116723623	0.6878300308464474	genomes
truth_sample_rank	syndip	VQSR	False	1073	65.0	2.73	2.89	1718	1522	147	49	113406	106771	5801	46245	13011	0.9484685356927122	0.6977767030898729	genomes
truth_sample_rank	syndip	VQSR	False	1077	66.0	2.56	2.73	1718	1492	178	48	115124	108263	5979	44753	12833	0.9476637313772518	0.7075273174047159	genomes
truth_sample_rank	syndip	VQSR	False	1081	67.0	2.38	2.56	1719	1444	214	61	116843	109707	6193	43309	12619	0.9465660051768766	0.7169642390338266	genomes
truth_sample_rank	syndip	VQSR	False	1085	68.0	2.2	2.38	1718	1448	218	52	118561	111155	6411	41861	12401	0.945468928091455	0.7264273017200815	genomes
truth_sample_rank	syndip	VQSR	False	1089	69.0	2.01	2.2	1718	1393	252	73	120279	112548	6663	40468	12149	0.9441075068575886	0.7355309248706018	genomes
truth_sample_rank	syndip	VQSR	False	1093	70.0	1.84	2.01	1718	1349	297	72	121997	113897	6960	39119	11852	0.9424112794459568	0.7443469963925341	genomes
truth_sample_rank	syndip	VQSR	False	1097	71.0	1.68	1.84	1719	1321	334	64	123716	115218	7294	37798	11518	0.9404629750555048	0.752980080514456	genomes
truth_sample_rank	syndip	VQSR	False	1101	72.0	1.52	1.68	1718	1290	331	97	125434	116508	7625	36508	11187	0.9385739489096372	0.7614105714435092	genomes
truth_sample_rank	syndip	VQSR	False	1105	73.0	1.35	1.52	1718	1284	338	96	127152	117792	7963	35224	10849	0.9366784620889825	0.7698018507868458	genomes
truth_sample_rank	syndip	VQSR	False	1109	74.0	1.19	1.35	1718	1238	347	133	128870	119030	8310	33986	10502	0.9347416365635307	0.7778925079730225	genomes
truth_sample_rank	syndip	VQSR	False	1113	75.0	1.01	1.19	1719	1205	375	139	130589	120235	8685	32781	10127	0.9326326403971456	0.7857675014377582	genomes
truth_sample_rank	syndip	VQSR	False	1117	76.0	0.811	1.01	1718	1164	398	156	132307	121399	9083	31617	9729	0.9303888658972119	0.7933745490667643	genomes
truth_sample_rank	syndip	VQSR	False	1121	77.0	0.61	0.811	1718	1140	409	169	134025	122539	9492	30477	9320	0.9281077928668268	0.8008247503529042	genomes
truth_sample_rank	syndip	VQSR	False	1125	78.0	0.369	0.61	1719	1130	414	175	135744	123669	9906	29347	8906	0.9258394160583941	0.8082095989961834	genomes
truth_sample_rank	syndip	VQSR	False	1129	79.0	0.063	0.369	1718	1095	395	228	137462	124764	10301	28252	8511	0.9237330174360493	0.8153657133894495	genomes
truth_sample_rank	syndip	VQSR	False	1133	80.0	-0.2692	0.063	1718	1015	422	281	139180	125779	10723	27237	8089	0.9214443744414001	0.8219990066398285	genomes
truth_sample_rank	syndip	VQSR	False	1137	81.0	-0.5927	-0.2692	1718	930	433	355	140898	126709	11156	26307	7656	0.9190802596743191	0.8280768024258901	genomes
truth_sample_rank	syndip	VQSR	False	1141	82.0	-0.8857	-0.5927	1719	824	516	379	142617	127533	11672	25483	7140	0.9161524370532668	0.8334618601976264	genomes
truth_sample_rank	syndip	VQSR	False	1145	83.0	-1.204	-0.8859	1718	787	521	410	144335	128320	12193	24696	6619	0.9132251108438365	0.8386051131907775	genomes
truth_sample_rank	syndip	VQSR	False	1149	84.0	-1.587	-1.204	1718	825	493	400	146053	129145	12686	23871	6126	0.9105555203023317	0.8439967062267998	genomes
truth_sample_rank	syndip	VQSR	False	1153	85.0	-2.009	-1.587	1719	830	548	341	147772	129975	13234	23041	5578	0.9075896067984554	0.8494209755842527	genomes
truth_sample_rank	syndip	VQSR	False	1157	86.0	-2.592	-2.009	1718	788	571	359	149490	130763	13805	22253	5007	0.9045086049471529	0.8545707638416897	genomes
truth_sample_rank	syndip	VQSR	False	1161	87.0	-3.518	-2.592	1718	690	703	325	151208	131453	14508	21563	4304	0.9006035858893814	0.8590800961990903	genomes
truth_sample_rank	syndip	VQSR	False	1165	88.0	-5.592	-3.518	1718	631	897	190	152926	132084	15405	20932	3407	0.8955515326566728	0.8632038479636116	genomes
truth_sample_rank	syndip	VQSR	False	1169	89.0	-30.33	-5.595	1719	199	1407	113	154645	132283	16812	20733	2000	0.8872396793990409	0.8645043655565431	genomes
truth_sample_rank	syndip	VQSR	False	1173	90.0	-23560.0	-30.39	1718	30	1056	632	156363	132313	17868	20703	944	0.881023564898356	0.8647004234851258	genomes
truth_sample_rank	syndip	VQSR	False	1177	91.0	-1.0	-1.0	1718	47	133	1538	158081	132360	18001	20656	811	0.8802814559626498	0.8650075809065718	genomes
truth_sample_rank	syndip	VQSR	False	1181	92.0	-1.0	-1.0	1719	46	78	1595	159800	132406	18079	20610	733	0.8798617802438782	0.8653082030637319	genomes
truth_sample_rank	syndip	VQSR	False	1185	93.0	-1.0	-1.0	1718	51	129	1538	161518	132457	18208	20559	604	0.8791491056316995	0.8656415015423223	genomes
truth_sample_rank	syndip	VQSR	False	1189	94.0	-1.0	-1.0	1718	44	103	1571	163236	132501	18311	20515	501	0.8785839323130785	0.8659290531709102	genomes
truth_sample_rank	syndip	VQSR	False	1193	95.0	-1.0	-1.0	1718	46	76	1596	164954	132547	18387	20469	425	0.8781785416142155	0.8662296753280703	genomes
truth_sample_rank	syndip	VQSR	False	1197	96.0	-1.0	-1.0	1719	49	98	1572	166673	132596	18485	20420	327	0.8776484137648016	0.8665499032780886	genomes
truth_sample_rank	syndip	VQSR	False	1201	97.0	-1.0	-1.0	1718	47	96	1575	168391	132643	18581	20373	231	0.8771292916468285	0.8668570606995347	genomes
truth_sample_rank	syndip	VQSR	False	1205	98.0	-1.0	-1.0	1718	38	131	1549	170109	132681	18712	20335	100	0.8764011546108472	0.867105400742406	genomes
truth_sample_rank	syndip	VQSR	False	1209	99.0	-1.0	-1.0	1718	44	100	1574	171827	132725	18812	20291	0	0.8758587011752905	0.8673929523709939	genomes
truth_sample_rank	syndip	VQSR	False	1213	100.0	-1.0	-1.0	1	0	0	1	171828	132725	18812	20291	0	0.8758587011752905	0.8673929523709939	genomes
truth_sample_rank	syndip	VQSR	True	1217	0.0	23.09	131.12	33616	33281	332	3	33616	33281	332	3268434	59561	0.990122869128016	0.010079913014902861	genomes
truth_sample_rank	syndip	VQSR	True	1221	1.0	22.98	23.09	33616	33614	2	0	67232	66895	334	3234820	59559	0.9950319058739532	0.020260682705805923	genomes
truth_sample_rank	syndip	VQSR	True	1225	2.0	22.89	22.98	33616	33612	4	0	100848	100507	338	3201208	59555	0.9966483216817889	0.03044084665090718	genomes
truth_sample_rank	syndip	VQSR	True	1229	3.0	22.81	22.89	33616	33605	11	0	134464	134112	349	3167603	59544	0.9974044518484914	0.04061889048570213	genomes
truth_sample_rank	syndip	VQSR	True	1233	4.0	22.74	22.81	33616	33612	3	1	168080	167724	352	3133991	59541	0.9979057093219734	0.05079905443080338	genomes
truth_sample_rank	syndip	VQSR	True	1237	5.0	22.68	22.74	33616	33614	1	1	201696	201338	353	3100377	59540	0.9982497979582629	0.060979824121706445	genomes
truth_sample_rank	syndip	VQSR	True	1241	6.0	22.62	22.68	33616	33613	3	0	235312	234951	356	3066764	59537	0.998487082832215	0.0711602909397086	genomes
truth_sample_rank	syndip	VQSR	True	1245	7.0	22.57	22.62	33616	33611	3	2	268928	268562	359	3033153	59534	0.9986650354565095	0.08134015201190896	genomes
truth_sample_rank	syndip	VQSR	True	1249	8.0	22.52	22.57	33616	33612	3	1	302544	302174	362	2999541	59531	0.9988034481846788	0.09152031595701023	genomes
truth_sample_rank	syndip	VQSR	True	1253	9.0	22.48	22.52	33616	33611	3	2	336160	335785	365	2965930	59528	0.9989141752193961	0.10170017702921058	genomes
truth_sample_rank	syndip	VQSR	True	1257	10.0	22.43	22.48	33616	33610	6	0	369776	369395	371	2932320	59522	0.9989966627542824	0.11187973522851004	genomes
truth_sample_rank	syndip	VQSR	True	1261	11.0	22.39	22.43	33616	33611	4	1	403392	403006	375	2898709	59518	0.9990703578006896	0.1220595963007104	genomes
truth_sample_rank	syndip	VQSR	True	1265	12.0	22.35	22.39	33616	33611	5	0	437008	436617	380	2865098	59513	0.9991304288130124	0.13223945737291073	genomes
truth_sample_rank	syndip	VQSR	True	1269	13.0	22.31	22.35	33617	33614	3	0	470625	470231	383	2831484	59510	0.9991861695572167	0.1424202270638138	genomes
truth_sample_rank	syndip	VQSR	True	1273	14.0	22.27	22.31	33616	33610	5	1	504241	503841	388	2797874	59505	0.9992305083602887	0.15259978526311327	genomes
truth_sample_rank	syndip	VQSR	True	1277	15.0	22.24	22.27	33616	33614	1	1	537857	537455	389	2764260	59504	0.9992767419549163	0.16278055495401633	genomes
truth_sample_rank	syndip	VQSR	True	1281	16.0	22.2	22.24	33616	33611	3	2	571473	571066	392	2730649	59501	0.9993140353271807	0.17296041602621667	genomes
truth_sample_rank	syndip	VQSR	True	1285	17.0	22.17	22.2	33616	33610	5	1	605089	604676	397	2697039	59496	0.9993438808209918	0.18313997422551614	genomes
truth_sample_rank	syndip	VQSR	True	1289	18.0	22.14	22.17	33616	33612	3	1	638705	638288	400	2663427	59493	0.9993737161180419	0.19332013817061738	genomes
truth_sample_rank	syndip	VQSR	True	1293	19.0	22.1	22.14	33616	33613	2	1	672321	671901	402	2629814	59491	0.9994020553232694	0.20350060498861955	genomes
truth_sample_rank	syndip	VQSR	True	1297	20.0	22.07	22.1	33616	33608	7	1	705937	705509	409	2596206	59484	0.9994206125923975	0.2136795574421172	genomes
truth_sample_rank	syndip	VQSR	True	1301	21.0	22.04	22.07	33616	33612	4	0	739553	739121	413	2562594	59480	0.9994415402131612	0.22385972138721846	genomes
truth_sample_rank	syndip	VQSR	True	1305	22.0	22.01	22.04	33616	33612	4	0	773169	772733	417	2528982	59476	0.9994606479984479	0.23403988533231973	genomes
truth_sample_rank	syndip	VQSR	True	1309	23.0	21.98	22.01	33616	33609	5	2	806785	806342	422	2495373	59471	0.9994769226192542	0.24421914065871828	genomes
truth_sample_rank	syndip	VQSR	True	1313	24.0	21.95	21.98	33616	33609	6	1	840401	839951	428	2461764	59465	0.999490705979088	0.2543983959851168	genomes
truth_sample_rank	syndip	VQSR	True	1317	25.0	21.92	21.95	33616	33611	4	1	874017	873562	432	2428153	59461	0.9995057174305545	0.2645782570573172	genomes
truth_sample_rank	syndip	VQSR	True	1321	26.0	21.89	21.92	33617	33614	1	2	907634	907176	433	2394539	59460	0.9995229223156668	0.2747590267482202	genomes
truth_sample_rank	syndip	VQSR	True	1325	27.0	21.86	21.89	33616	33612	2	2	941250	940788	435	2360927	59458	0.999537835348265	0.2849391906933215	genomes
truth_sample_rank	syndip	VQSR	True	1329	28.0	21.83	21.86	33616	33611	4	1	974866	974399	439	2327316	59454	0.9995496687654769	0.29511905176552183	genomes
truth_sample_rank	syndip	VQSR	True	1333	29.0	21.81	21.83	33616	33611	4	1	1008482	1008010	443	2293705	59450	0.999560713290555	0.3052989128377222	genomes
truth_sample_rank	syndip	VQSR	True	1337	30.0	21.78	21.81	33616	33615	1	0	1042098	1041625	444	2260090	59449	0.9995739245673751	0.31547998540152616	genomes
truth_sample_rank	syndip	VQSR	True	1341	31.0	21.75	21.78	33616	33606	8	2	1075714	1075231	452	2226484	59441	0.999579801856123	0.325658332109222	genomes
truth_sample_rank	syndip	VQSR	True	1345	32.0	21.72	21.75	33616	33608	6	2	1109330	1108839	458	2192876	59435	0.9995871259004577	0.33583728456271966	genomes
truth_sample_rank	syndip	VQSR	True	1349	33.0	21.7	21.72	33616	33611	3	2	1142946	1142450	461	2159265	59432	0.9995966440081511	0.34601714563492003	genomes
truth_sample_rank	syndip	VQSR	True	1353	34.0	21.67	21.7	33616	33610	6	0	1176562	1176060	467	2125655	59426	0.9996030690328399	0.3561967038342195	genomes
truth_sample_rank	syndip	VQSR	True	1357	35.0	21.64	21.67	33616	33608	6	2	1210178	1209668	473	2092047	59420	0.9996091364559998	0.3663756562877171	genomes
truth_sample_rank	syndip	VQSR	True	1361	36.0	21.61	21.64	33616	33608	6	2	1243794	1243276	479	2058439	59414	0.9996148759200968	0.37655460874121477	genomes
truth_sample_rank	syndip	VQSR	True	1365	37.0	21.58	21.61	33616	33606	10	0	1277410	1276882	489	2024833	59404	0.9996171824787004	0.3867329554489106	genomes
truth_sample_rank	syndip	VQSR	True	1369	38.0	21.56	21.58	33617	33609	6	2	1311027	1310491	495	1991224	59398	0.9996224215971795	0.3969122107753092	genomes
truth_sample_rank	syndip	VQSR	True	1373	39.0	21.53	21.56	33616	33606	8	2	1344643	1344097	503	1957618	59390	0.9996259110516139	0.40709055748300504	genomes
truth_sample_rank	syndip	VQSR	True	1377	40.0	21.5	21.53	33616	33609	6	1	1378259	1377706	509	1924009	59384	0.999630681715117	0.4172698128094036	genomes
truth_sample_rank	syndip	VQSR	True	1381	41.0	21.47	21.5	33616	33604	10	2	1411875	1411310	519	1890405	59374	0.9996323917414928	0.4274475537712976	genomes
truth_sample_rank	syndip	VQSR	True	1385	42.0	21.44	21.47	33616	33607	7	2	1445491	1444917	526	1856798	59367	0.99963609772229	0.4376262033518944	genomes
truth_sample_rank	syndip	VQSR	True	1389	43.0	21.41	21.44	33616	33604	10	2	1479107	1478521	536	1823194	59357	0.9996376069346888	0.44780394431378845	genomes
truth_sample_rank	syndip	VQSR	True	1393	44.0	21.37	21.41	33616	33606	6	4	1512723	1512127	542	1789588	59351	0.9996416929281952	0.4579822910214843	genomes
truth_sample_rank	syndip	VQSR	True	1397	45.0	21.34	21.37	33616	33609	7	0	1546339	1545736	549	1755979	59344	0.999644955490094	0.4681615463478828	genomes
truth_sample_rank	syndip	VQSR	True	1401	46.0	21.31	21.34	33616	33609	4	3	1579955	1579345	553	1722370	59340	0.9996499774036045	0.4783408016742814	genomes
truth_sample_rank	syndip	VQSR	True	1405	47.0	21.28	21.31	33616	33607	7	2	1613571	1612952	560	1688763	59333	0.9996529309977242	0.48851945125487817	genomes
truth_sample_rank	syndip	VQSR	True	1409	48.0	21.24	21.28	33616	33601	14	1	1647187	1646553	574	1655162	59319	0.9996515144248136	0.4986962835980695	genomes
truth_sample_rank	syndip	VQSR	True	1413	49.0	21.21	21.24	33616	33609	7	0	1680803	1680162	581	1621553	59312	0.9996543195479618	0.508875538924468	genomes
truth_sample_rank	syndip	VQSR	True	1417	50.0	21.18	21.21	33616	33608	6	2	1714419	1713770	587	1587945	59306	0.9996575975715677	0.5190544913779657	genomes
truth_sample_rank	syndip	VQSR	True	1421	51.0	21.14	21.18	33616	33608	7	1	1748035	1747378	594	1554337	59299	0.9996601776229825	0.5292334438314633	genomes
truth_sample_rank	syndip	VQSR	True	1425	52.0	21.11	21.14	33617	33607	8	2	1781652	1780985	602	1520730	59291	0.9996620990162142	0.5394120934120601	genomes
truth_sample_rank	syndip	VQSR	True	1429	53.0	21.07	21.11	33616	33601	12	3	1815268	1814586	614	1487129	59279	0.9996617452622301	0.5495889257552514	genomes
truth_sample_rank	syndip	VQSR	True	1433	54.0	21.03	21.07	33616	33607	6	3	1848884	1848193	620	1453522	59273	0.9996646496968595	0.5597675753358482	genomes
truth_sample_rank	syndip	VQSR	True	1437	55.0	20.99	21.03	33616	33606	8	2	1882500	1881799	628	1419916	59265	0.9996663881255422	0.569945922043544	genomes
truth_sample_rank	syndip	VQSR	True	1441	56.0	20.95	20.99	33616	33610	5	1	1916116	1915409	633	1386306	59260	0.9996696314590181	0.5801254802428435	genomes
truth_sample_rank	syndip	VQSR	True	1445	57.0	20.91	20.95	33616	33605	10	1	1949732	1949014	643	1352701	59250	0.9996701983990004	0.5903035240776384	genomes
truth_sample_rank	syndip	VQSR	True	1449	58.0	20.87	20.91	33616	33608	6	2	1983348	1982622	649	1319093	59244	0.9996727628246468	0.6004824765311361	genomes
truth_sample_rank	syndip	VQSR	True	1453	59.0	20.82	20.87	33616	33601	12	3	2016964	2016223	661	1285492	59232	0.9996722667243133	0.6106593088743274	genomes
truth_sample_rank	syndip	VQSR	True	1457	60.0	20.77	20.82	33616	33604	11	1	2050580	2049827	672	1251888	59221	0.9996722748950377	0.6208370498362215	genomes
truth_sample_rank	syndip	VQSR	True	1461	61.0	20.71	20.77	33616	33603	11	2	2084196	2083430	683	1218285	59210	0.999672282644943	0.6310144879252146	genomes
truth_sample_rank	syndip	VQSR	True	1465	62.0	20.65	20.71	33616	33599	14	3	2117812	2117029	697	1184686	59196	0.9996708733802201	0.6411907145226041	genomes
truth_sample_rank	syndip	VQSR	True	1469	63.0	20.59	20.65	33616	33601	13	2	2151428	2150630	710	1151085	59183	0.9996699731330241	0.6513675468657955	genomes
truth_sample_rank	syndip	VQSR	True	1473	64.0	20.51	20.59	33617	33601	13	3	2185045	2184231	723	1117484	59170	0.999669100585184	0.6615443792089869	genomes
truth_sample_rank	syndip	VQSR	True	1477	65.0	20.43	20.51	33616	33592	19	5	2218661	2217823	742	1083892	59151	0.9996655495782184	0.6717184856960701	genomes
truth_sample_rank	syndip	VQSR	True	1481	66.0	20.33	20.43	33616	33591	20	5	2252277	2251414	762	1050301	59131	0.9996616605451795	0.6818922893102524	genomes
truth_sample_rank	syndip	VQSR	True	1485	67.0	20.22	20.33	33616	33589	20	7	2285893	2285003	782	1016712	59111	0.9996578855841647	0.6920654871786329	genomes
truth_sample_rank	syndip	VQSR	True	1489	68.0	20.09	20.22	33616	33586	26	4	2319509	2318589	808	983126	59085	0.9996516335926967	0.7022377764283108	genomes
truth_sample_rank	syndip	VQSR	True	1493	69.0	19.96	20.09	33616	33583	23	10	2353125	2352172	831	949543	59062	0.9996468342794294	0.7124091570592859	genomes
truth_sample_rank	syndip	VQSR	True	1497	70.0	19.83	19.96	33616	33583	27	6	2386741	2385755	858	915960	59035	0.999640494709448	0.722580537690261	genomes
truth_sample_rank	syndip	VQSR	True	1501	71.0	19.7	19.83	33616	33585	26	5	2420357	2419340	884	882375	59009	0.9996347445525703	0.7327525240670378	genomes
truth_sample_rank	syndip	VQSR	True	1505	72.0	19.56	19.7	33616	33583	26	7	2453973	2452923	910	848792	58983	0.9996291516170823	0.742923904698013	genomes
truth_sample_rank	syndip	VQSR	True	1509	73.0	19.41	19.56	33616	33586	25	5	2487589	2486509	935	815206	58958	0.999624112140816	0.7530961939476908	genomes
truth_sample_rank	syndip	VQSR	True	1513	74.0	19.26	19.41	33616	33577	30	9	2521205	2520086	965	781629	58928	0.9996172231343198	0.7632657573412606	genomes
truth_sample_rank	syndip	VQSR	True	1517	75.0	19.11	19.26	33616	33563	39	14	2554821	2553649	1004	748066	58889	0.9996069916344803	0.7734310805142176	genomes
truth_sample_rank	syndip	VQSR	True	1521	76.0	18.94	19.11	33616	33553	41	22	2588437	2587202	1045	714513	58848	0.9995962518260428	0.7835933749581657	genomes
truth_sample_rank	syndip	VQSR	True	1525	77.0	18.76	18.94	33617	33553	50	14	2622054	2620755	1095	680960	58798	0.9995823559700212	0.7937556694021137	genomes
truth_sample_rank	syndip	VQSR	True	1529	78.0	18.57	18.76	33616	33547	48	21	2655670	2654302	1143	647413	58750	0.9995695636701193	0.8039161466086564	genomes
truth_sample_rank	syndip	VQSR	True	1533	79.0	18.38	18.57	33616	33558	43	15	2689286	2687860	1186	613855	58707	0.9995589513901957	0.814079955417109	genomes
truth_sample_rank	syndip	VQSR	True	1537	80.0	18.16	18.38	33616	33544	48	24	2722902	2721404	1234	580311	58659	0.9995467631025498	0.8242395240049489	genomes
truth_sample_rank	syndip	VQSR	True	1541	81.0	17.91	18.16	33616	33514	77	25	2756518	2754918	1311	546797	58582	0.9995243501174975	0.8343900064057619	genomes
truth_sample_rank	syndip	VQSR	True	1545	82.0	17.59	17.91	33616	33506	82	28	2790134	2788424	1393	513291	58500	0.99950068409505	0.8445380658233675	genomes
truth_sample_rank	syndip	VQSR	True	1549	83.0	17.25	17.59	33616	33502	82	32	2823750	2821926	1475	479789	58418	0.9994775804074589	0.8546849137493696	genomes
truth_sample_rank	syndip	VQSR	True	1553	84.0	16.92	17.25	33616	33499	78	39	2857366	2855425	1553	446290	58340	0.9994564186353553	0.8648308530566691	genomes
truth_sample_rank	syndip	VQSR	True	1557	85.0	16.47	16.92	33616	33463	105	48	2890982	2888888	1658	412827	58235	0.9994264059454512	0.874965888939536	genomes
truth_sample_rank	syndip	VQSR	True	1561	86.0	15.54	16.47	33616	33294	232	90	2924598	2922182	1890	379533	58003	0.9993536410868132	0.8850497393021506	genomes
truth_sample_rank	syndip	VQSR	True	1565	87.0	14.25	15.54	33616	33113	351	152	2958214	2955295	2241	346420	57652	0.9992422746502494	0.895078769669702	genomes
truth_sample_rank	syndip	VQSR	True	1569	88.0	11.65	14.25	33616	32032	1121	463	2991830	2987327	3362	314388	56531	0.9988758443288487	0.9047803944313788	genomes
truth_sample_rank	syndip	VQSR	True	1573	89.0	2.64	11.65	33617	30832	1721	1064	3025447	3018159	5083	283556	54810	0.9983186923177172	0.914118571711974	genomes
truth_sample_rank	syndip	VQSR	True	1577	90.0	1.06	2.64	33616	32141	611	864	3059063	3050300	5694	251415	54199	0.9981367764465506	0.9238532096198491	genomes
truth_sample_rank	syndip	VQSR	True	1581	91.0	0.608	1.06	33616	32907	260	449	3092679	3083207	5954	218508	53939	0.9980726158332311	0.9338198481698148	genomes
truth_sample_rank	syndip	VQSR	True	1585	92.0	0.133	0.608	33616	32817	325	474	3126295	3116024	6279	185691	53614	0.9979889844131079	0.9437592281586994	genomes
truth_sample_rank	syndip	VQSR	True	1589	93.0	-0.4106	0.133	33616	32641	471	504	3159911	3148665	6750	153050	53143	0.9978608202090692	0.9536453025170253	genomes
truth_sample_rank	syndip	VQSR	True	1593	94.0	-2.071	-0.4107	33616	29915	1781	1920	3193527	3178580	8531	123135	51362	0.9973232811784717	0.9627057453474936	genomes
truth_sample_rank	syndip	VQSR	True	1597	95.0	-7.319	-2.071	33616	27728	4829	1059	3227143	3206308	13360	95407	46533	0.9958505038407687	0.9711038051436904	genomes
truth_sample_rank	syndip	VQSR	True	1601	96.0	-16.17	-7.32	33616	27534	5358	724	3260759	3233842	18718	67873	41175	0.9942451484369236	0.9794431075971124	genomes
truth_sample_rank	syndip	VQSR	True	1605	97.0	-46.06	-16.17	33616	24431	6227	2958	3294375	3258273	24945	43442	34948	0.9924022711863787	0.986842595439037	genomes
truth_sample_rank	syndip	VQSR	True	1609	98.0	-210600.0	-46.06	33616	9209	17402	7005	3327991	3267482	42347	34233	17546	0.9872056834356095	0.9896317519834389	genomes
truth_sample_rank	syndip	VQSR	True	1613	99.0	-1.0	-1.0	33616	9500	17546	6570	3361607	3276982	59893	24733	0	0.9820511706312044	0.9925090445420032	genomes
truth_sample_rank	syndip	VQSR	True	1617	100.0	-1.0	-1.0	1	0	0	1	3361608	3276982	59893	24733	0	0.9820511706312044	0.9925090445420032	genomes
